Xue, Xue, Xue, Xue, Xue, Xue, Xue, Xue, Xue, Xue, Xue, Xue, Xue, Rb, Xue, Xue, Uu, Uu, Uu, Uu, Xue, Xue, Xue, Xue, Xue, Xue, Xue, Xue, Xue, Xue, Xue, Xue, Xue, Rb, Xue, Xue, Xue, Xue, Xue, Xue, Xue, Xue, Xue, Xue, Xue, Xue, Xue, Xue, Xue, Xue, Xue, Xue, Xue, Xue, Xue, Xue, Xue, Xue, Xue, Xue, Xue, Xue, Xue, Xue, Xue, Xue, Xue, Xue, Xue, Xue, Xue, Xue
Xue, Xue, Xue, Xue, Xue, Xue, Xue, Xue, Rb^Vov, Xue, Xue, Xue, Xue, Xue, Uue, Uu, Uue^Ux, Uu^Ux, Uu^Ux, Uu^Ux, Rb^Ux, Uue, rabid1 Rb^Vov, Xue, Xue, Xue, Xue, Xue, Rb, rabid2 Rb^Vov, Rb, Uue, Uue, Xue, Rb^Vov, Xue, Xue, Xue, Xue, Xue, Xue, Xue, Xue, Xue, Xue, Xue, Xue, Xue, Xue, Xue, Xue, Xue, Xue, Xue, Xue, Xue, Xue, Xue, Xue, Xue, Xue, Xue, Xue, Xue, Xue, Xue, Xue, Xue, Rb, Xue, Xue, Xue
Xue, Xue, Xue, Xue, Rb, Rb^Ux, Rb^Ux, Rb, Rb, Rb, Xue, Xue, Xue, Xue, Xue, Uue^Ux, Rb^Ux, Uue^Ux, Uue, Uue^Ux, Uue, Uue, Rb, Xue, Xue, Xue, Rb, Rb, Rb, Rb^Ux, Rb, Rb, Uue^Ecf, dwarf_camp Rb, Rb, Xue, Xue, Xue, Xue, Xue, Xue, Xue, Xue, Xue, Rb, Xue, Xue, Xue, Xue, Xue, Xue, Xue, Xue, Rb, Rb, Rb, Uue, Rb, Rb, Rb, Rb, Rb, Rb, Xue, Rb^Ux, Xue, Rb, Rb, Rb, Rb, Re^Ii, Re^Ii
Xue, Xue, Xue, Rb, Rb, Rb, Rb^Ux, Rb^Ux, Uue, Rb, Rb, Xue, Xue, Xue, Xue, Xue, Xue, Xue, Xue, Rb, Rb, Rb, Uue, Xue, Xue, Xue, Xue, Rb, Xue, Rb^Ux, Xue, Rb, Xue, Rb, Xue, Xue, Xue, Xue, Xue, Xue, Xue, Xue, Uue, Rb, Rb^Ux, Rb^Ux, Rb, Xue, Xue, Xue, Xue, Xue, Xue, Rb, 3 Uu^Kov, Rb, Uue, Rb, Xue, Xue, Rb, Rb, Rb, Rb, Uue^Ux, Uue, Uue, Uue, Rb, Rb, Re^Ii, Re^Ii
Xue, Xue, Xue, Rb^Ux, Rb^Ux, Rb, Uue^Ux, Uue^Ux, Uue, Rb, Rb^Ux, Rb, Xue, Xue, Xue, Xue, Xue, Xue, Xue, Rb, Uue, Uue^Ux, Uue^Ux, Xue, Xue, Xue, Xue, Rb, Xue, Xue, Xue, Xue, Xue, Xue, Xue, Xue, Xue, Xue, Xue, Xue, Xue, Rb, Uue, Uue^Ux, Rb^Ux, Rb^Ux, Rb^Ux, Rb, Rb, Xue, Xue, Xue, Rb, Rb, Uu^Cov, Uu^Cov, Uue^Ux, Xue, Xue, Xue, Uue, Uue, Rb, Rb^Ux, Uue^Ux, Uue^Ux, Uue, Rb, Rb, Rb, Xue, Re^Ii
Xue, Xue, Xue, Rb^Ux, Rb^Ux, Rb, Rb, Rb^Ux, Rb, Rb, Rb^Ux, Rb^Ux, Rb^Ux, Xue, Rb, Xue, Xue, Xue, Rb, Rb^Ux, Rb^Ux, Uue^Ux, Rb^Ux, Xue, Xue, Xue, Xue, Rb, Xue, Xue, Xue, Xue, Xue, Xue, Gg, Xue, Ss^Vov, Xue, Xue, Xue, Xue, Rb, Uue^Ux, Uue^Ux, Uue^Ux, Rb^Ux, Rb^Ux, Rb, Uue, Xue, Xue, Xue, Xue, Rb, Uue, Uue^Ux, Rb^Ux, Xue, Rb, Uue, Uue, Rb, Rb, Rb, Rb, Uue, Xue, Xue, Xue, Xue, Xue, Xue
Xue, Xue, Uue, Rb^Ux, Uue, Rb, Xue, Xue, Xue, Rb^Ux, Uue^Vov, Uue^Ux, Rb, Rb, Uu^Cov, Rb, Rb, Rb, Rb, Rb, Rb, Rb^Ux, Rb, Xue, Xue, Xue, Xue, Rb, Rb, Xue, Ss, Ss^Vov, Ss, Gg, Gg, Gg, Gg, Xue, Xue, Xue, Rb, Rb, Rb, Uue, Rb^Ux, Uue, Rb, Rb, Uue, Xue, Xue, Xue, Xue, Xue, Xue, Rb^Ux, Rb, Rb, Rb, Uue, Uue, Rb, Rb^Ux, Rb^Vov, Rb^Ux, Xue, Xue, Xue, Xue, Xue, Xue, Xue
Xue, Xue, Rb^Vov, Uue, Rb^Ux, Rb, Xue, Xue, Xue, Xue, Xue, Rb, Rb, Uu^Cov, 2 Uu^Kov, Rb^Ux, Rb^Ux, Rb^Ux, Uue^Ux, Rb^Ux, Rb^Vov, Rb, Rb, Xue, Uue, Xue, Xue, Xue, Gg, Gg, Gg, Gg, Gg, Gg, Gg^Fet, Gg, Gs^Fds, Gg, Gg, Rb, Rb, Rb, Rb, Rb, Rb^Ux, Rb, Rb, Uue, Uue, Rb, Rb, Xue, Xue, Xue, Xue, Xue, Xue, Rb^Vov, Xue, Xue, Xue, Rb^Ux, Rb^Ux, Rb^Ux, Rb^Ux, Xue, Xue, Xue, Xue, Xue, Xue, Xue
Xue, Xue, Rb^Ux, Rb^Ux, Rb^Ux, Rb^Ux, Rb, Xue, spider_nest_tunnel Xue, Xue, Xue, Xue, Xue, Rb, Rb, Rb^Ux, Rb^Ux, Uue^Ux, Uue^Ux, Uue^Ux, Rb^Ux, Rb^Ux, Rb, Rb, Rb, Uue, Gg^Vov, Gg, Gg, Gg, Gg, Gg, Gg, Gs^Fds, Gs^Fds, Gs^Fds, Gs^Fds, Gs^Fds, Gg, Gg, Gg, Rb, Xue, Xue, Xue, Rb, Rb, Uue, Rb, Rb, Rb^Ux, Rb, Xue, Xue, Xue, Xue, Xue, Xue, Xue, Xue, Xue, Rb^Ux, Rb^Ux, Uue^Ux, Uue, Xue, Xue, Xue, Xue, Xue, Xue, Xue
Xue, Xue, Xue, Rb, Uue, Rb^Ux, Rb, spider_nest_entry Rb, Xue, Rb, Rb, Xue, Xue, Xue, Xue, Rb, Uue, Rb^Ux, Rb^Ux, Uue^Ux, Uue, Rb, Uue, Rb, Rb, Gg, Gg, Gg, Gs^Fds, Gg, Ss, Gg, Gg^Vov, Gs^Fds, Ss, Gs^Fds, Gg, Gg, Gg, Gg, Gg, Xue, Xue, Xue, Xue, Rb, Rb, Rb, Xue, Rb^Vov, Rb^Ux, Rb^Ux, Rb^Ux, Xue, Xue, Xue, Xue, Xue, Xue, Xue, Rb, Rb, Rb, Uue, Uue, Rb, Xue, Xue, Xue, Xue, Xue, Xue
Xue, Xue, Xue, Rb, Rb, Uue, Rb, Xue, Xue, Xue, Rb, Xue, Xue, Xue, Xue, Rb, Uue, secret_cave Rb^Ux, Rb, Uue, Rb, Rb, Xue, Uue, Gg, Gg, Gg, Gg, Gs^Fds, Gs^Fds, Gs^Fds, Gs^Fds, Gg, Gg, Gg, Gg, Gg, Gg, Gg, Gg, Xue, Xue, Xue, Xue, Uue, Rb, Rb, Xue, Xue, Xue, Rb, Rb^Ux, Rb, Uue, Rb, Xue, Xue, Xue, Rb, Rb^Ux, Rb^Ux, Rb, Rb, Uue, Rb, Rb, Xue, Xue, Xue, Xue, Xue, Xue
Xue, Xue, Xue, Rb^Ux, Rb^Ux, Uue, Rb^Ux, Xue, Xue, Xue, Rb, Uue, Xue, Xue, Xue, Xue, Xue, Uue, Uue^Vov, Rb, Xue, Xue, Xue, Xue, Gg, Gg, Gg, Gs^Fds, Gs^Fds, Gs^Fds, Ss, Gg, Gg, Gg, Gs^Fds, Gg, Gs^Fds, Gs^Fds, Gg, Gg, Xue, Xue, Xue, Xue, Uue, Uue, Uue, Xue, Xue, Xue, Rb, Rb, Uue^Ux, Uue, Rb, Rb, Rb, Uue, Rb, Rb^Ux, Rb^Ux, Rb, Rb, Rb, Rb^Ux, Rb, Uue, Xue, Rb, rabid3 Rb^Vov, Xue, Xue
Xue, Xue, Xue, Rb^Ux, Uue^Ux, Rb^Ux, Rb, Xue, Xue, Xue, Rb, Rb, Rb, spider_nest2 Uue^Vov, Uue, Xue, Xue, Xue, Xue, Xue, Xue, Xue, Xue, Xue, Ss^Cov, Gg, Gg, Gg, Gg, Gg^Fet, Gg, Gg, Gg, Gg, Gs^Fds, Gs^Fds, Gs^Fds, Gs^Fds, Gg, Xue, Xue, Xue, Xue, Xue, Xue, Uue, Uue, Uue, Rb, Rb, Rb, Uue, Uue^Ux, Uue^Ux, Rb^Ux, Rb^Ux, Rb, Uue, Uue, Rb, Xue, Xue, Xue, Rb^Ux, Rb, Uue^Ux, Uue^Ux, Rb^Ux, Rb, Rb, Xue, Xue
Xue, Xue, Rb, Uue, Rb, Rb, Rb, Xue, Xue, Xue, Rb, Rb^Ux, Uue^Ux, Uue^Ux, Rb^Ux, Rb, Rb, Xue, Xue, Xue, Xue, Xue, Xue, Xue, Xue, 5 Ss^Kov, Gg, Gg, Gg, Gg, Gg, Gg, Gg, Gg, Gg, Gs^Fds, Gg, Ss, Gg, Xue, Xue, Xue, Xue, Xue, Xue, Uue^Vov, Uue, Uue, Rb, Rb, Rb, Rb^Ux, Uue, Rb, Rb, Rb, Xue, Uue, Xue, Xue, Xue, Xue, Xue, Rb, Uue, Uue^Ux, Uue^Ux, Rb, Xue, Xue, Xue, Xue
Rb^Ii, Rb, 1 Ke, Rb, Rb, Rb, Xue, Xue, Xue, Uue, Rb, Rb, Uue, Uue^Ux, Rb, Rb, Rb, Xue, Rb, potion_chest Rb, Xue, Xue, Xue, Xue, Xue, Ss^Cov, Gg, Gg, Gg, Gg, Gg^Vov, Gg, Xue, Gg, Xue, Gg, Gg^Vov, Gg, Xue, Xue, Xue, Xue, Xue, Xue, Xue, Uue, Uue, Uue, Xue, Rb, Xue, Rb, Rb, Rb, Rb^Vov, Xue, Xue, Xue, Xue, Xue, Xue, Xue, Xue, Rb, Rb, Uue, Xue, Xue, Xue, Xue, Xue, Xue
Rb^Ii, Ce^Ii, Rb^Ii, Ce, Rb, Xue, Xue, Xue, Xue, spider_nest Rb^Vov, Xue, Xue, Xue, Rb, Xue, Rb, Xue, Uue, Xue, Xue, Xue, Xue, Xue, Xue, Xue, Xue, Xue, Xue, Xue, Xue, Xue, Xue, Xue, Xue, Xue, Xue, Xue, Xue, Xue, Xue, Xue, Xue, Xue, Xue, Xue, Xue, Xue, Xue, Xue, Xue, Xue, Xue, Xue, Xue, Xue, Xue, Xue, Xue, Xue, Xue, Xue, Xue, Xue, Xue, Xue, Xue, Xue, Xue, Xue, Xue, Xue, Xue
Rb, Rb^Ii, Rb^Ii, Rb^Ii, Rb^Ii, Xue, Xue, Xue, Xue, Xue, Xue, Xue, Xue, Xue, Xue, Xue, Xue, Xue, Xue, Xue, Xue, Xue, Xue, Xue, Xue, Xue, Xue, Xue, Xue, Xue, Xue, Xue, Xue, Xue, Xue, Xue, Xue, Xue, Xue, Xue, Xue, Xue, Xue, Xue, Xue, Xue, Xue, Xue, Xue, Xue, Xue, Xue, Xue, Xue, Xue, Xue, Xue, Xue, Xue, Xue, Xue, Xue, Xue, Xue, Xue, Xue, Xue, Xue, Xue, Xue, Xue, Xue
