Xue, Xue, Xue, Xue, Xue, Xue, Xue, Xue, Xue, Xue, Xue, Xue, Xue, Rb, Xue, Xue, Uu, Uu, Uu, Uu, Xue, Xue, Xue, Xue, Xue, Xue, Xue, Xue, Xue, Xue, Xue, Xue, Xue, Rb, Xue, Xue, Xue, Xue, Xue, Xue, Xue, Xue, Xue, Xue, Xue, Xue, Xue, Xue, Xue, Xue, Xue, Xue, Xue, Xue, Xue, Xue, Xue, Xue, Xue, Xue, Xue, Xue, Xue, Xue, Xue, Xue, Xue, Xue, Xue, Xue, Xue, Xue
Xue, Xue, Xue, Xue, Xue, Xue, Xue, Xue, Rb^Vov, Xue, Xue, Xue, Xue, Xue, Uue, Uu, Uue^Uf, Uu^Uf, Uu^Uf, Uu^Uf, Rb^Uf, Uue, rabid1 Rb^Vov, Xue, Xue, Xue, Xue, Xue, Rb, rabid2 Rb^Vov, Rb, Uue, Uue, Xue, Rb^Vov, Xue, Xue, Xue, Xue, Xue, Xue, Xue, Xue, Xue, Xue, Xue, Xue, Xue, Xue, Xue, Xue, Xue, Xue, Xue, Xue, Xue, Xue, Xue, Xue, Xue, Xue, Xue, Xue, Xue, Xue, Xue, Xue, Xue, Rb, Xue, Xue, Xue
Xue, Xue, Xue, Xue, Rb, Rb^Uf, Rb^Uf, Rb, Rb, Rb, Xue, Xue, Xue, Xue, Xue, Uue^Uf, Rb^Uf, Uue^Uf, Uue, Uue^Uf, Uue, Uue, Rb, Xue, Xue, Xue, Rb, Rb, Rb, Rb^Uf, Rb, Rb, Uue^Ecf, dwarf_camp Rb, Rb, Xue, Xue, Xue, Xue, Xue, Xue, Xue, Xue, Xue, Rb, Xue, Xue, Xue, Xue, Xue, Xue, Xue, Xue, Rb, Rb, Rb, Uue, Rb, Rb, Rb, Rb, Rb, Rb, Xue, Rb^Uf, Xue, Rb, Rb, Rb, Rb, Re^Ii, Re^Ii
Xue, Xue, Xue, Rb, Rb, Rb, Rb^Uf, Rb^Uf, Uue, Rb, Rb, Xue, Xue, Xue, Xue, Xue, Xue, Xue, Xue, Rb, Rb, Rb, Uue, Xue, Xue, Xue, Xue, Rb, Xue, Rb^Uf, Xue, Rb, Xue, Rb, Xue, Xue, Xue, Xue, Xue, Xue, Xue, Xue, Uue, Rb, Rb^Uf, Rb^Uf, Rb, Xue, Xue, Xue, Xue, Xue, Xue, Rb, 3 Uu^Kov, Rb, Uue, Rb, Xue, Xue, Rb, Rb, Rb, Rb, Uue^Uf, Uue, Uue, Uue, Rb, Rb, Re^Ii, Re^Ii
Xue, Xue, Xue, Rb^Uf, Rb^Uf, Rb, Uue^Uf, Uue^Uf, Uue, Rb, Rb^Uf, Rb, Xue, Xue, Xue, Xue, Xue, Xue, Xue, Rb, Uue, Uue^Uf, Uue^Uf, Xue, Xue, Xue, Xue, Rb, Xue, Xue, Xue, Xue, Xue, Xue, Xue, Xue, Xue, Xue, Xue, Xue, Xue, Rb, Uue, Uue^Uf, Rb^Uf, Rb^Uf, Rb^Uf, Rb, Rb, Xue, Xue, Xue, Rb, Rb, Uu^Cov, Uu^Cov, Uue^Uf, Xue, Xue, Xue, Uue, Uue, Rb, Rb^Uf, Uue^Uf, Uue^Uf, Uue, Rb, Rb, Rb, Xue, Re^Ii
Xue, Xue, Xue, Rb^Uf, Rb^Uf, Rb, Rb, Rb^Uf, Rb, Rb, Rb^Uf, Rb^Uf, Rb^Uf, Xue, Rb, Xue, Xue, Xue, Rb, Rb^Uf, Rb^Uf, Uue^Uf, Rb^Uf, Xue, Xue, Xue, Xue, Rb, Xue, Xue, Xue, Xue, Xue, Xue, Gg, Xue, Ss^Vov, Xue, Xue, Xue, Xue, Rb, Uue^Uf, Uue^Uf, Uue^Uf, Rb^Uf, Rb^Uf, Rb, Uue, Xue, Xue, Xue, Xue, Rb, Uue, Uue^Uf, Rb^Uf, Xue, Rb, Uue, Uue, Rb, Rb, Rb, Rb, Uue, Xue, Xue, Xue, Xue, Xue, Xue
Xue, Xue, Uue, Rb^Uf, Uue, Rb, Xue, Xue, Xue, Rb^Uf, Uue^Vov, Uue^Uf, Rb, Rb, Uu^Cov, Rb, Rb, Rb, Rb, Rb, Rb, Rb^Uf, Rb, Xue, Xue, Xue, Xue, Rb, Rb, Xue, Ss, Ss^Vov, Ss, Gg, Gg, Gg, Gg, Xue, Xue, Xue, Rb, Rb, Rb, Uue, Rb^Uf, Uue, Rb, Rb, Uue, Xue, Xue, Xue, Xue, Xue, Xue, Rb^Uf, Rb, Rb, Rb, Uue, Uue, Rb, Rb^Uf, Rb^Vov, Rb^Uf, Xue, Xue, Xue, Xue, Xue, Xue, Xue
Xue, Xue, Rb^Vov, Uue, Rb^Uf, Rb, Xue, Xue, Xue, Xue, Xue, Rb, Rb, Uu^Cov, 2 Uu^Kov, Rb^Uf, Rb^Uf, Rb^Uf, Uue^Uf, Rb^Uf, Rb^Vov, Rb, Rb, Xue, Uue, Xue, Xue, Xue, Gg, Gg, Gg, Gg, Gg, Gg, Gg^Fet, Gg, Gs^Fds, Gg, Gg, Rb, Rb, Rb, Rb, Rb, Rb^Uf, Rb, Rb, Uue, Uue, Rb, Rb, Xue, Xue, Xue, Xue, Xue, Xue, Rb^Vov, Xue, Xue, Xue, Rb^Uf, Rb^Uf, Rb^Uf, Rb^Uf, Xue, Xue, Xue, Xue, Xue, Xue, Xue
Xue, Xue, Rb^Uf, Rb^Uf, Rb^Uf, Rb^Uf, Rb, Xue, spider_nest_tunnel Xue, Xue, Xue, Xue, Xue, Rb, Rb, Rb^Uf, Rb^Uf, Uue^Uf, Uue^Uf, Uue^Uf, Rb^Uf, Rb^Uf, Rb, Rb, Rb, Uue, Gg^Vov, Gg, Gg, Gg, Gg, Gg, Gg, Gs^Fds, Gs^Fds, Gs^Fds, Gs^Fds, Gs^Fds, Gg, Gg, Gg, Rb, Xue, Xue, Xue, Rb, Rb, Uue, Rb, Rb, Rb^Uf, Rb, Xue, Xue, Xue, Xue, Xue, Xue, Xue, Xue, Xue, Rb^Uf, Rb^Uf, Uue^Uf, Uue, Xue, Xue, Xue, Xue, Xue, Xue, Xue
Xue, Xue, Xue, Rb, Uue, Rb^Uf, Rb, spider_nest_entry Rb, Xue, Rb, Rb, Xue, Xue, Xue, Xue, Rb, Uue, Rb^Uf, Rb^Uf, Uue^Uf, Uue, Rb, Uue, Rb, Rb, Gg, Gg, Gg, Gs^Fds, Gg, Ss, Gg, Gg^Vov, Gs^Fds, Ss, Gs^Fds, Gg, Gg, Gg, Gg, Gg, Xue, Xue, Xue, Xue, Rb, Rb, Rb, Xue, Rb^Vov, Rb^Uf, Rb^Uf, Rb^Uf, Xue, Xue, Xue, Xue, Xue, Xue, Xue, Rb, Rb, Rb, Uue, Uue, Rb, Xue, Xue, Xue, Xue, Xue, Xue
Xue, Xue, Xue, Rb, Rb, Uue, Rb, Xue, Xue, Xue, Rb, Xue, Xue, Xue, Xue, Rb, Uue, secret_cave Rb^Uf, Rb, Uue, Rb, Rb, Xue, Uue, Gg, Gg, Gg, Gg, Gs^Fds, Gs^Fds, Gs^Fds, Gs^Fds, Gg, Gg, Gg, Gg, Gg, Gg, Gg, Gg, Xue, Xue, Xue, Xue, Uue, Rb, Rb, Xue, Xue, Xue, Rb, Rb^Uf, Rb, Uue, Rb, Xue, Xue, Xue, Rb, Rb^Uf, Rb^Uf, Rb, Rb, Uue, Rb, Rb, Xue, Xue, Xue, Xue, Xue, Xue
Xue, Xue, Xue, Rb^Uf, Rb^Uf, Uue, Rb^Uf, Xue, Xue, Xue, Rb, Uue, Xue, Xue, Xue, Xue, Xue, Uue, Uue^Vov, Rb, Xue, Xue, Xue, Xue, Gg, Gg, Gg, Gs^Fds, Gs^Fds, Gs^Fds, Ss, Gg, Gg, Gg, Gs^Fds, Gg, Gs^Fds, Gs^Fds, Gg, Gg, Xue, Xue, Xue, Xue, Uue, Uue, Uue, Xue, Xue, Xue, Rb, Rb, Uue^Uf, Uue, Rb, Rb, Rb, Uue, Rb, Rb^Uf, Rb^Uf, Rb, Rb, Rb, Rb^Uf, Rb, Uue, Xue, Rb, rabid3 Rb^Vov, Xue, Xue
Xue, Xue, Xue, Rb^Uf, Uue^Uf, Rb^Uf, Rb, Xue, Xue, Xue, Rb, Rb, Rb, spider_nest2 Uue^Vov, Uue, Xue, Xue, Xue, Xue, Xue, Xue, Xue, Xue, Xue, Ss^Cov, Gg, Gg, Gg, Gg, Gg^Fet, Gg, Gg, Gg, Gg, Gs^Fds, Gs^Fds, Gs^Fds, Gs^Fds, Gg, Xue, Xue, Xue, Xue, Xue, Xue, Uue, Uue, Uue, Rb, Rb, Rb, Uue, Uue^Uf, Uue^Uf, Rb^Uf, Rb^Uf, Rb, Uue, Uue, Rb, Xue, Xue, Xue, Rb^Uf, Rb, Uue^Uf, Uue^Uf, Rb^Uf, Rb, Rb, Xue, Xue
Xue, Xue, Rb, Uue, Rb, Rb, Rb, Xue, Xue, Xue, Rb, Rb^Uf, Uue^Uf, Uue^Uf, Rb^Uf, Rb, Rb, Xue, Xue, Xue, Xue, Xue, Xue, Xue, Xue, 5 Ss^Kov, Gg, Gg, Gg, Gg, Gg, Gg, Gg, Gg, Gg, Gs^Fds, Gg, Ss, Gg, Xue, Xue, Xue, Xue, Xue, Xue, Uue^Vov, Uue, Uue, Rb, Rb, Rb, Rb^Uf, Uue, Rb, Rb, Rb, Xue, Uue, Xue, Xue, Xue, Xue, Xue, Rb, Uue, Uue^Uf, Uue^Uf, Rb, Xue, Xue, Xue, Xue
Rb^Ii, Rb, 1 Ke, Rb, Rb, Rb, Xue, Xue, Xue, Uue, Rb, Rb, Uue, Uue^Uf, Rb, Rb, Rb, Xue, Rb, potion_chest Rb, Xue, Xue, Xue, Xue, Xue, Ss^Cov, Gg, Gg, Gg, Gg, Gg^Vov, Gg, Xue, Gg, Xue, Gg, Gg^Vov, Gg, Xue, Xue, Xue, Xue, Xue, Xue, Xue, Uue, Uue, Uue, Xue, Rb, Xue, Rb, Rb, Rb, Rb^Vov, Xue, Xue, Xue, Xue, Xue, Xue, Xue, Xue, Rb, Rb, Uue, Xue, Xue, Xue, Xue, Xue, Xue
Rb^Ii, Ce^Ii, Rb^Ii, Ce, Rb, Xue, Xue, Xue, Xue, spider_nest Rb^Vov, Xue, Xue, Xue, Rb, Xue, Rb, Xue, Uue, Xue, Xue, Xue, Xue, Xue, Xue, Xue, Xue, Xue, Xue, Xue, Xue, Xue, Xue, Xue, Xue, Xue, Xue, Xue, Xue, Xue, Xue, Xue, Xue, Xue, Xue, Xue, Xue, Xue, Xue, Xue, Xue, Xue, Xue, Xue, Xue, Xue, Xue, Xue, Xue, Xue, Xue, Xue, Xue, Xue, Xue, Xue, Xue, Xue, Xue, Xue, Xue, Xue, Xue
Rb, Rb^Ii, Rb^Ii, Rb^Ii, Rb^Ii, Xue, Xue, Xue, Xue, Xue, Xue, Xue, Xue, Xue, Xue, Xue, Xue, Xue, Xue, Xue, Xue, Xue, Xue, Xue, Xue, Xue, Xue, Xue, Xue, Xue, Xue, Xue, Xue, Xue, Xue, Xue, Xue, Xue, Xue, Xue, Xue, Xue, Xue, Xue, Xue, Xue, Xue, Xue, Xue, Xue, Xue, Xue, Xue, Xue, Xue, Xue, Xue, Xue, Xue, Xue, Xue, Xue, Xue, Xue, Xue, Xue, Xue, Xue, Xue, Xue, Xue, Xue
