border_size=1
usage=map

Xue         , Xue         , Xue         , Xue         , Xue         , Xue         , Xue         , Xue         , Xue         , Xue         , Xue         , Xue         , Xue         , Xue         , Xue         , Xue         , Xue         , Xue         , Xue         , Xue         , Xue         , Xue         , Xue         , Xue         , Xue         , Xue         , Xue         , Xue         , Xue         , Xue         , Xue         , Xue         , Xue         , Xue         
Xue         , Xue         , Xue         , Xue         , Xue         , Xue         , Xue         , Xue         , Uue         , Xue         , Uue         , Xue         , Uue         , Xue         , Uue^Vov     , Xue         , Xue         , Xue         , Xue         , Xue         , Xue         , Xue         , Uue         , Xue         , Uue         , Xue         , Uue         , Xue         , Rb          , Xue         , Xue         , Xue         , Xue         , Xue         
Xue         , Xue         , Xue         , Xue         , Uue         , Uue         , Uue         , Uue         , Uue         , Uu^Cov      , 2 Uu^Kov    , Uue         , Uue         , Uue         , Uue         , Uue         , Uue         , Xue         , Xue         , Xue         , Xue         , Uue         , 3 Uu^Kov    , Uu^Cov      , Uue         , Uue         , Xue         , Uue         , Rb          , Uue         , Uue         , Xue         , Xue         , Xue         
Xue         , Xue         , Xue         , Rb          , Rb          , Uue         , Uue         , Rb          , Uue         , Uu^Cov      , Uue         , Uue         , Uue         , Uue         , Uue         , Rb          , Rb          , Uue         , Xue         , Xue         , Xue         , Uue         , Uue         , Uu^Cov      , Uue         , Uue         , Xue         , Xue         , Xue         , Uue^Uf      , Uue         , Uue         , Uue         , Xue         
Xue         , Xue         , Uue^Vov     , Rb          , Uue         , Uue         , Xue         , Uue         , Xue         , Uue         , Xue         , Xue         , Xue         , Uue         , Uue         , Uue         , Uue         , Uue         , Xue         , Xue         , Xue         , Xue         , Xue         , Uue         , Uue         , Xue         , Xue         , Xue         , Xue         , Uue         , Uue         , Uue         , Uue^Ii      , Uue^Ii      
Xue         , Xue         , Uue         , Uue         , Xue         , Xue         , Xue         , Xue         , Uue^Vov     , Xue         , Uue         , Xue         , Xue         , Xue         , Xue         , Uue^Uf      , Uue^Uf      , Uue         , Rb          , Rb^Vov      , Uue         , Xue         , Xue         , Rb          , Rb          , Rb^Vov      , Xue         , Xue         , Uue         , Uue         , Uue         , Uue         , Uue^Ii      , Uue^Ii      
Xue         , Xue         , Rb          , Uue         , Uue         , Uue         , Rb          , Uue^Uf      , Uue         , Uue         , Uue         , Uue         , Uue         , Xue         , Xue         , Uue^Uf      , Uue         , Uue         , Rb          , Rb          , Uue         , Xue         , Xue         , Uue         , Uue^Uf      , Rb^Uf       , Uue         , Uue         , Uue         , Uue         , Xue         , Xue         , Xue         , Uue^Ii      
Xue         , Xue         , Uue         , Uue         , Uue         , Rb          , Uue         , Uue         , Uue         , Uue         , Uue         , Uue         , Uue^Uf      , Uue^Uf      , Uue^Uf      , Xue         , Uue         , Rb          , Uue         , Uue         , Uue         , Xue         , Xue         , Uue         , Uue         , Uue         , Uue         , Uue         , Xue         , Xue         , Xue         , Xue         , Xue         , Xue         
Xue         , Xue         , Xue         , Uue         , Xue         , Uue         , Xue         , Xue         , Xue         , Uue         , Uue         , Rb          , Uue         , Uue         , Uue^Vov     , Xue         , Uue         , Uue         , Uue         , Uue         , Uue^Uf      , Xue         , Xue         , Uue^Vov     , Uue         , Uue         , Uue         , Uue         , Xue         , Xue         , Xue         , Xue         , Xue         , Xue         
Xue         , Xue         , Xue         , Xue         , Uue^Vov     , Xue         , Uue         , Xue         , Uue^Uf      , Uue         , Rb^Uf       , Rb          , Uue         , Uue         , Xue         , Xue         , Xue         , Uue         , Gg          , Uue^Uf      , Xue         , Xue         , Xue         , Xue         , Xue         , Uue         , Uue^Uf      , Uue         , Uue         , Xue         , Xue         , Xue         , Xue         , Xue         
Xue         , Xue         , Uue         , Uue         , Uue         , Uue         , Uue         , Uue         , Uue^Uf      , Uue^Uf      , Rb          , Rb          , Uue         , Uue         , Xue         , Xue         , Gg          , Gg          , Gg          , Gg          , Gg          , Gg          , Gg          , Gg^Vov      , Gg          , Xue         , Uue         , Uue^Uf      , Uue^Uf      , Uue         , Xue         , Xue         , Xue         , Xue         
Xue         , Xue         , Uue         , Uue         , Xue         , Xue         , Xue         , Uue         , Uue         , Uue         , Uue         , Uue         , Uue         , Uue         , Xue         , Xue         , Ss^Cov      , Gg          , Gs^Fds      , Gs^Fds      , Gs^Fds      , Gg          , Gg          , Gg          , Gg          , Xue         , Xue         , Uue^Uf      , Rb^Uf       , Uue         , Uue         , Xue         , Xue         , Xue         
Xue         , Xue         , Rb          , Uue         , Uue         , Xue         , Uue         , Xue         , Xue         , Uue         , Uue         , Uue         , Xue         , Xue         , Ss^Cov      , 5 Ss^Kov    , Gg          , Gg          , Gg          , Gs^Fds      , Ss          , Gg          , Gg          , Gg          , Gg          , Xue         , Xue         , Rb          , Rb          , Uue         , Uue         , Uue         , Uue         , Xue         
Xue         , Xue         , Rb^Uf       , Uue^Uf      , Xue         , Xue         , Xue         , Rb          , Rb          , Xue         , Xue         , Uue         , Xue         , Gg          , Gg          , Gg          , Gg          , Gg          , Ss          , Gg          , Gg          , Gg          , Gg          , Gg          , Gg          , Gg          , Xue         , Rb^Vov      , Xue         , Xue         , Uue         , Uue         , Rb          , Xue         
Xue         , Xue         , Uue         , Uue         , Xue         , Xue         , Xue         , Xue         , Xue         , Uue         , Uue         , Xue         , Xue         , Xue         , Gg          , Gg          , Gg          , Gg          , Gg          , Gg          , Gg          , Gg          , Gg          , Gg          , Gs^Fds      , Gg^Vov      , Xue         , Xue         , Uue         , Xue         , Xue         , Rb          , Uue         , Xue         
Xue         , Xue         , Uue         , Uue         , Uue         , Xue         , Xue         , Xue         , Xue         , Xue         , Xue         , Uue         , Xue         , Gg          , Gg          , Gs^Fds      , Gs^Fds      , Gg          , Gs^Fds      , Gg          , Gg          , Gg          , Gg          , Ss          , Gs^Fds      , Gs^Fds      , Gg          , Uue         , Uue         , Xue         , Xue         , Uue         , Uue         , Xue         
Xue         , Xue         , Uue         , Uue         , Uue         , Uue         , Xue         , Xue         , Xue         , Xue         , Xue         , Uue         , Xue         , Xue         , Xue         , Gg          , Gg          , Gs^Fds      , Ss          , Gs^Fds      , Gg          , Gg          , Gg          , Gs^Fds      , Gs^Fds      , Gs^Fds      , Gg          , Uue         , Uue         , Xue         , Xue         , Uue         , Uue         , Xue         
Xue         , Xue         , Xue         , Uue         , Uue^Uf      , Uue         , Uue         , Xue         , Xue         , Xue         , Xue         , Rb          , Xue         , Xue         , Xue         , Gg^Vov      , Xue         , Gg          , Gg          , Gg          , Xue         , Gg          , Xue         , Gg          , Gg          , Gg          , Xue         , Xue         , Uue         , Xue         , Xue         , Uue         , Uue         , Xue         
Xue         , Xue         , Xue         , Xue         , Uue^Uf      , Uue         , Rb          , Uue         , Xue         , Xue         , Xue         , Uue         , Xue         , Xue         , Uue^Vov     , Xue         , Xue         , Xue         , Uue         , Xue         , Xue         , Xue         , Uue         , Xue         , Xue         , Xue         , Xue         , Xue         , Uue         , Xue         , Xue         , Uue         , Uue         , Xue         
Xue         , Xue         , Xue         , Xue         , Uue         , Rb^Uf       , Rb          , Uue         , Xue         , Xue         , Uue         , Uue         , Uue         , Uue         , Uue         , Xue         , Xue         , Uue         , Uue         , Xue         , Xue         , Xue         , Uue         , Uue         , Rb          , Uue         , Uue         , Uue         , Xue         , Xue         , Uue         , Uue         , Uue         , Xue         
Xue         , Xue         , Xue         , Xue         , Uue         , Uue         , Rb          , Uue         , Xue         , Xue         , Uue         , Uue         , Rb          , Rb          , Uue^Uf      , Uue^Uf      , Xue         , Uue         , Uue         , Xue         , Xue         , Xue         , Xue         , Rb          , Rb          , Rb          , Uue         , Xue         , Uue^Vov     , Uue         , Rb          , Uue         , Xue         , Xue         
Xue         , Xue         , Xue         , Xue         , Uue         , Uue         , Rb          , Uue         , Xue         , Xue         , Uue         , Uue         , Rb          , Uue         , Uue         , Uue         , Xue         , Uue         , Rb          , Uue         , Uue         , Xue         , Xue         , Uue         , Uue         , Uue         , Uue^Vov     , Xue         , Uue         , Rb          , Rb          , Uue         , Xue         , Xue         
Xue         , Xue         , Xue         , Xue         , Uue         , Rb          , Uue         , Uue         , Xue         , Xue         , Uue         , Uue         , Uue         , Uue         , Xue         , Xue         , Uue         , Uue         , Rb          , Rb          , Uue^Uf      , Uue^Uf      , Xue         , Xue         , Xue         , Xue         , Xue         , Xue         , Uue         , Rb          , Uue         , Uue         , Xue         , Xue         
Xue         , Xue         , Xue         , Xue         , Uue         , Uue         , Uue         , Uue         , Xue         , Xue         , Xue         , Uue         , Uue         , Uue         , Xue         , Xue         , Uue         , Uue         , Uue         , Rb^Uf       , Uue         , Uue^Uf      , Uue         , Uue         , Rb          , Rb          , Uue         , Uue         , Uue         , Uue         , Uue         , Uue         , Xue         , Xue         
Xue         , Xue         , Uue         , Uue         , Uue^Uf      , Uue^Uf      , Uue         , Xue         , Xue         , Xue         , Xue         , Uue^Vov     , Xue         , Uue         , Uue         , Xue         , Xue         , Uue         , Uue         , Uue         , Uue         , Uue         , Uue         , Rb          , Rb          , Uue         , Uue         , Uue         , Uue         , Uue         , Xue         , Xue         , Xue         , Xue         
Uue^Ii      , Uue^Ii      , Ce          , 1 Ke        , Ce          , Uue^Uf      , Xue         , Xue         , Xue         , Xue         , Xue         , Xue         , Xue         , Xue         , Xue         , Xue         , Xue         , Xue         , Xue         , Uue^Vov     , Xue         , Uue         , Xue         , Rb          , Xue         , Uue         , Xue         , Uue         , Xue         , Xue         , Xue         , Xue         , Xue         , Xue         
Uue^Ii      , Uue^Ii      , Uue         , Uue         , Uue         , Uue         , Xue         , Xue         , Xue         , Xue         , Xue         , Xue         , Xue         , Xue         , Xue         , Xue         , Xue         , Xue         , Xue         , Xue         , Xue         , Xue         , Xue         , Xue         , Xue         , Xue         , Xue         , Xue         , Xue         , Xue         , Xue         , Xue         , Xue         , Xue         
