Xue, Xue, Xue, Xue, Xue, Xue, Xue, Xue, Xue, Xue, Xue, Xue, Xue, Xue, Xue, Xue, Xue, Xue, Xue, Xue, Xue, Xue, Xue, Xue, Xue, Xue, Xue, Xue, Xue, Xue, Xue, Xue, Xue, Xue, Xue, Xue, Xue, Xue, Xue, Xue, Xue, Xue, Xue, Xue, Xue, Xue
Xue, Xue, Xue, Xue, Xue, Xue, Xue, Xue, Xue, Xue, Xue, Xue, Xue, Xue, Xue, Xue, Xue, Xue, Xue, Xue, Xue, Xue, Uu, Xue, Uu^Ux, Xue, Xue, Xue, Xue, Xue, Xue, Xue, Xue, Xue, Xue, Xue, Xue, Xue, Xue, Xue, Xue, Xue, Xue, Xue, Xue, Xue
Xue, Xue, Xue, Xue, Xue, Xue, Xue, Xue, Xue, Xue, Xue, Xue, Xue, Xue, Xue, Xue, Xue, Xue, Xue, Xue, Uu, Uu^Ux, Qlf, Uu, Qlf, Uu, Uu, Xue, Uu, Xue, Xue, Xue, Uue, Uue, Uue, Xue, Uue, Xue, Xue, Xue, Xue, Xue, Xue, Xue, Xue, Xue
Xue, Xue, Xue, Xue, Uue, Xue, Uue, Uue, Uue, Uue, Uue, Xue, Xue, Xue, Qlf, Qlf, Qlf, Qlf, Qlf, Qlf, Qlf^Bsb|, Qlf, Xue, Qlf, Qlf, Qlf, Qlf, Uu^Ux, Qlf, Uu, Uu^Es, Uue, Uue^Es, Uue^Ux, Uue^Ux, Uue, Uue^Ux, Uue, Uue, Xue, Xue, Xue, Xue, Xue, Xue, Xue
Xue, Xue, Xue, chest2 Uue, Uue^Es, Uue, Uue^Es, Uue^Es, Uue, Uue^Vu, Uue, Uue, Uu, Qlf, Uu, Uu^Ux, Uu, Uu^Es, Uu^Ux, Uu, Uu, Uu, Xue, Xue, Xue, Uu, Uu, Qlf, Qlf, Qlf, Uu, Uue, Uue, Uue^Vu, Co, Uue^Ux, Uue^Ux, Uue, Uue, Xue, Xue, Xue, Xue, Xue, Xue, Xue
Xue, Xue, Xue, Uue, Uue, Uue, Uue^Ux, Uue, Uue, Uue, Xue, Xue, Xue, Uu, Xue, Xue, Xue, Xue, Xue, Xue, Xue, Xue, Xue, Xue, Xue, chest1 Uu, Xue, Xue, Xue, Qlf, Uu, Uue^Ux, Ur, Ur, Uue, 3 Ko, Co, Uue^Ux, Uue, Uue, Xue, Xue, Xue, Xue, Xue, Xue
Xue, Xue, Xue, Uue, Uue^Ux, Uue^Ux, Uue^Ux, Uue^Ux, Uue, Uue, Xue, Xue, Xue, Xue, Xue, Xue, Rb, Xue, Rb, Xue, Rb, Xue, Xue, Xue, Xue, Xue, Xue, Xue, Xue, Uu, Uue^Ux, Uue^Ux, Ur, Uue, Uue, Uue, Uue^Vu, Urb, Urb, Uue, Xue, Xue, Xue, Xue, Xue, Xue
Xue, Xue, Xue, Uue, Uue, Uue^Ux, Uue^Es, Uue, Uue^Es, Uue, Uue, Uue, Uue, Xue, Rb, Rb, Rb, Rb, Rb^Fetd, Rb^Dr, Rb^Dr, Rb, Rb, Xue, Xue, Xue, Xue, Xue, Uue, Uue, Uue, Uue^Ux, Ur, Uue^Ux, Uue, Uue, Uue, Urb, Urb^Ux, Uue, Xue, Xue, Xue, Xue, Xue, Xue
Xue, Xue, Xue, Uue, Uue^Vu, Uue, Uue, Uue, Xue, Uue, Uue, Uue, scout_start Uue, Rb, Rb, Rb, Rb^Ux, Rb^Ux, Rb^Fetd, Rb^Dr, Rb^Dr, Rb, Rb, Rb^Vu, Rb, Rb, Rb, Uue, Uue, Uue, Uue, Uue^Vu, Ur, Uue, Uue^Ux, Uue, Uue^Ux, Urb, Urb, Urb, Xue, Xue, Xue, Xue, Xue, Xue
Xue, Xue, Xue, Uue, Uue^Ux, Uue, Uue, Xue, Xue, Xue, Xue, Uue, Rb, Rb, Rb, Rb, Rb^Ux, Rb^Ux, Rb^Es, Rb^Dr, Rb^Dr, Rb^Ux, Rb^Ux, Rb, Rb^Dr, Rb^Dr, Rb^Dr, Rb, Rb, Uue^Es, Ur, Ur, Uue, Uue, Uue, Uue^Ux, Uue, Uue, Urb, Urb, Xue, Xue, Xue, Xue, Xue, Xue
Xue, Xue, Xue, Uue, Uue^Ux, Uue^Ux, Uue, Xue, Xue, Xue, Xue, Rb, Rb^Ux, Rb^Ux, Rb, Rb, Rb, Rb^Es, Rb, Rb, Rb, Rb^Ux, Rb^Ux, Rb, Rb^Dr, Rb^Dr, Rb, Rb^Es, Rb, Rb, Rb, Uue, Xue, Uue, Xue, Uue, Xue, Xue, Xue, Urb, Xue, Xue, Xue, Xue, Xue, Xue
Xue, Xue, Xue, Uue, Uue, Uue, Uue, Xue, Xue, Xue, Xue, Rb^Ux, Rb^Ux, Rb, Rb^Vu, Rb, Rb, Rb, Rb^Es, Rb, Rb, Rb^Ux, Rb, Rb, Rb^Es, kalg_start Rb^Dr, Rb^Vu, Rb, Rb, Rb^Es, Rb, Rb, Rb, Xue, Xue, Xue, Xue, Xue, Xue, Urb, Urb, Xue, Xue, Xue, Xue, Xue
Xue, Xue, Xue, Uue, Uue, Uue, Xue, Xue, Xue, Xue, Xue, Rb, Rb, Rb, Rb, Rb^Ux, Rb^Ux, Rb^Fetd, Rb^Fetd, Rb, Rb, Rb, Rb, Rb, Rb^Vct, Rb^Es, Rb, Rb, Rb^Ux, Rb, Rb^Fetd, Rb^Fetd, Rb, Rb, Rb, Xue, Xue, Xue, Xue, Urb, Urb, Xue, Xue, Xue, potion_cache Uue^Vu, Xue
Xue, Xue, Xue, Uue^Es, Uue, Uue^Es, Xue, Xue, Xue, Xue, Xue, Rb, Rb, Rb, Rb^Ux, Rb^Ux, Rb, Rb^Fetd, Rb, Rb, Rb^Vu, Rb^Ux, Rb^Ux, Ce, Ce^Es, Ce, Rb^Ux, Rb^Ux, Rb^Ux, Rb, Rb, Rb^Fetd, Rb, Rb^Ux, Rb, Xue, Xue, Xue, Xue, Urb, Urb, Ql, Ql, Uue, Uue, Uue
Xue, Xue, Xue, Uue, Uue, Uue, Uue, Xue, Xue, Xue, Xue, Rb, Rb^Fetd, Rb^Fetd, Rb, Rb^Ux, Rb, Rb, Rb^Es, Rb, Rb, Rb^Ux, Ce^Es, Ce, 1 Ke, Ce, Ce^Es, Rb^Ux, Rb, Qxua, Qxua, Rb^Dr, Rb^Ux, Rb^Ux, Rb^Ux, Xue, Xue, Xue, Xue, Urb, Urb, Ql, Ql, Ql, Xue, Uue
Xue, Xue, Xue, Xue, Uue^Vu, Uue, Uue^Ux, Xue, Xue, Xue, Xue, Rb, Rb, Rb, Rb, Rb^Dr, Rb^Dr, Rb, Rb, Rb, Rb^Ux, Rb, Rb^Vct, Ce, Ce^Es, Ce, Rb^Vct, Rb, Rb, Qxua, Rb, Rb, Rb^Fetd, Rb, Rb, Xue, Xue, Xue, Xue, Urb, Urb, Ql, Ql, Ql, Xue, Xue
Xue, Xue, Xue, Xue, Xue, Uue^Ux, Uue, Xue, Xue, Xue, Xue, Rb, Rb, Rb^Vu, Rb, Rb^Dr, Rb, Rb, Rb^Es, Rb, Rb^Ux, Rb^Dr, Rb^Dr, Ce^Es, Rb, Ce, chasm_start Rb, Rb^Vu, Qxua, Qxua, Rb, Rb^Fetd, Rb^Fetd, Rb, Rb^Vu, Xue, Xue, Xue, Xue, Urb, Urb, Ql, Xue, Xue, Xue, Xue
Xue, Xue, Xue, Xue, Xue, Uue, Uue, Xue, Xue, Xue, Xue, Rb, Rb, Rb, Rb, Rb, Rb^Ux, Rb, Rb, Rb, Rb^Fetd, Rb, Rb, Rb, Rb, Rb^Es, Qxua, Qxua, Qxua, Rb^Ux, Rb^Ux, Rb, Rb^Dr, Rb, Rb, Xue, Xue, Xue, Xue, Xue, Urb, Urb, Urb, Xue, Xue, Xue
Xue, Xue, Xue, Xue, Xue, Uue, Uue, Xue, Xue, Xue, Xue, Xue, Xue, Rb, Rb^Ux, Rb^Ux, Rb^Ux, Rb, Rb, Rb^Fetd, Rb^Fetd, Rb, Rb^Es, Rb, Qxua, Qxua, Qxua, Qxua, Rb^Dr, Rb^Ux, Rb, Rb^Es, Rb^Dr, Rb^Dr, Rb, Xue, Xue, Xue, Xue, Xue, Xue, Urb, Urb, Xue, Xue, Xue
Xue, Xue, Xue, Xue, Xue, Xue, Uue, Xue, Xue, Xue, Xue, Xue, Xue, Rb, Rb, Rb^Ux, Rb, Rb, Rb^Vu, Rb, Rb, Rb, Rb, Rb^Vu, Rb, Rb, Rb^Dr, Rb^Dr, Rb^Dr, Rb, Rb^Es, Rb, Rb^Ux, Rb^Dr, Xue, Xue, Xue, Xue, Xue, Xue, Xue, Urb, Urb, Xue, Xue, Xue
Xue, Xue, Xue, Xue, Xue, Xue, Uue^Vu, Xue, Xue, Xue, Xue, Xue, Xue, Rb, Rb, Rb, Rb^Es, Rb, Rb, Rb, Rb, Rb, Rb^Ux, Rb, Rb^Fetd, Rb^Fetd, Rb, Rb^Dr, Rb, Rb, Rb, Rb, Urb, Xue, Xue, Xue, Xue, Xue, Xue, Xue, Xue, Urb, Urb, Xue, Xue, Xue
Xue, Xue, Xue, Xue, Xue, Xue, Uue^Ux, Xue, Xue, Xue, Xue, Xue, Xue, Xue, Uue, Rb, Rb, Rb, Rb, Rb, Rb^Ux, Rb^Ux, Rb^Ux, Rb^Ux, Rb, Rb^Fetd, Rb^Es, Rb^Vu, Rb, Rb, Uue^Ux, Urb, Urb, Urb, Xue, Xue, Xue, Xue, Xue, Xue, Xue, Urb, Urb, Xue, Xue, Xue
Xue, Xue, Xue, Xue, Xue, Xue, Uue, Uue^Ux, Uue^Ux, Xue, Xue, Xue, Uue^Vu, Xue, Ur, Ur, Uue, Uue, Xue, Rb, Rb, Rb^Ux, Rb^Ux, Rb^Ux, Rb^Dr, Rb, Rb, Rb, Xue, Xue, Xue, Uue^Ux, Uue^Ux, Urb, Urb, Xue, Uue^Ux, Xue, Xue, Xue, Xue, Urb, Urb, Urb, Xue, Xue
Xue, Xue, Xue, Xue, Xue, Xue, Uue^Ux, Uue^Ux, Uue, Uue, Uue, Uue^Ux, Ur, Ur, Uue, Uue, Xue, Xue, Xue, Rb, Rb^Es, Rb, Rb, Rb, Rb^Dr, Rb^Dr, Rb^Dr, Rb, Xue, Xue, Xue, Xue, Uue^Ux, Urb^Ux, Urb, Urb, Cud, Uue^Ux, Uue^Ux, Xue, Xue, Xue, Urb, Urb, Xue, Xue
Xue, Xue, Xue, Xue, Xue, Xue, Uue^Ux, Uue, Uue^Es, Uue^Es, Ur, Ur, Xue, Xue, Xue, Xue, Xue, Xue, Xue, Rb, Rb, Rb^Vu, Rb, Rb, Xue, Rb^Dr, Xue, Xue, Xue, Xue, Xue, Xue, Uue^Ux, Uue^Ux, Urb^Ux, Urb, Cud, Uue^Ux, Urb, Uue, Uue^Vu, Xue, Urb, Urb, Xue, Xue
Xue, Xue, Xue, Xue, Xue, Xue, Uue, Uue, Ur, Ur, Uue, Uue, Xue, Xue, Xue, Xue, Xue, Xue, Xue, Xue, Xue, Rb, Xue, Xue, Xue, Xue, Xue, Xue, Xue, Xue, Xue, Xue, Uue^Ux, Uue^Ux, Uue^Ux, Cud, 2 Kud, Cud, Urb, Urb, Urb, Urb, Urb, Xue, Xue, Xue
Xue, Xue, Xue, Xue, Xue, Xue, Xue, Ur, Uue^Ux, Uue, Uue^Ux, Uue, Xue, Xue, Xue, Xue, Xue, Xue, Xue, Xue, Xue, Xue, Xue, Xue, Xue, Xue, Xue, Xue, Xue, Xue, Uue^Vu, Xue, Ur, Uue^Ux, Uue, Cud, Kud, Cud, Uue, Urb^Ux, Urb^Ux, Urb, Xue, Xue, Xue, Xue
Xue, Xue, Xue, Xue, Xue, Xue, Uue^Vu, Ur, Uue^Ux, Uue^Ux, Uue^Ux, Uue, Uue^Es, Xue, Uue, Xue, Xue, Xue, Xue, Xue, Xue, Xue, Xue, Xue, Uue^Es, Xue, Uue, Xue, Ur, Ur, Ur, Ur, Uue^Es, Ur^Es, Ur, Cud, Cud, Cud, Uue, Uue, Uue^Ux, Xue, Xue, Xue, Xue, Xue
Xue, Xue, Xue, Xue, Xue, Xue, Uue, Ur, Uue^Ux, Uue^Ux, Uue^Ux, Uue, Uue^Es, Uue, Ur, Ur, Ur, Uue, Uue, Xue, Uue, Xue, Uue^Ux, Uue, Uue, Uue, Ur, Ur, Uue, Uue^Ux, Uue^Ux, Uue^Ux, Uue^Es, Uue, Uue, Uue, Cud, Uue, Uue^Ux, Uue^Ux, Uue, Xue, Xue, Xue, Xue, Xue
Xue, Xue, Xue, Xue, Xue, Xue, Uue, Ur, Ur, Uue, Uue^Vu, Uue, Ur, Ur, Xue, Xue, Ur, Uue^Vu, Xue, Uue, Xue, Uue^Ux, Xue, Uue^Ux, Xue, Uue, Ur, Uue, Xue, Uue^Ux, Uue^Ux, Uue^Ux, Uue, Uue, Uue^Vu, Uue, Uue^Es, Uue, Uue, Uue^Ux, Xue, Xue, Xue, Xue, Xue, Xue
Xue, Xue, Xue, Xue, Uue, Uue, Uue, Uue^Es, Uue, Ur, Ur, Ur, Uue, Uue, Uue, Uue, Uue, Ur, Ur, Xue, Uue^Ux, Uue^Ux, Uue, Xue, Uue, Uue^Vu, Ur, Xue, Uue, Uue, Uue, Uue, Uue, Uue, Uue, Uue, Uue, Uue, Uue, Uue, Xue, Xue, Xue, Xue, Xue, Xue
Xue, Xue, Xue, Uue, Uue, Uue, Uue, Uue, Xue, Xue, Xue, Xue, Xue, Uue, Xue, Uue, Xue, Uue, Uue, Ur, Ur, Ur, Ur, Ur, Ur, Ur, Xue, Uue, Xue, Uue, Xue, Xue, Xue, Uue, Xue, Uue, Xue, Xue, Uue, Uue, Xue, Xue, Xue, Xue, Xue, Xue
Xue, Xue, Uue, Uue, Uue, Uue, Xue, Xue, Xue, Xue, Xue, Xue, Xue, Xue, Xue, Xue, Xue, Xue, Xue, Xue, Xue, Uue, Xue, Uue, Xue, Xue, Xue, Xue, Xue, Xue, Xue, Xue, Xue, Xue, Xue, Xue, Xue, Xue, Uue, Uue, Xue, Xue, Xue, Xue, Xue, Xue
Xue, Uue, Uue, Uue, Xue, Xue, Xue, Xue, Xue, Xue, Xue, Xue, Xue, Xue, Xue, Xue, Xue, Xue, Xue, Xue, Xue, Xue, Xue, Xue, Xue, Xue, Xue, Xue, Xue, Xue, Xue, Xue, Xue, Xue, Xue, Xue, Uue, Uue, Uue, Uue, Xue, Xue, Xue, Xue, Xue, Xue
Xue, Uue, Uue, Xue, Xue, Xue, Xue, Xue, Xue, Xue, Xue, Xue, Xue, Xue, Xue, Xue, Xue, Xue, Xue, Xue, Xue, Xue, Xue, Xue, Xue, Xue, Xue, Xue, Xue, Xue, Xue, Xue, Xue, Xue, Xue, Xue, Uue, Uue, Uue, Uue, Xue, Xue, Xue, Xue, Xue, Xue
