border_size=1
usage=map

Xue, Xue, Xue, Xue, Xue, Xue, Xue, Xue, Xue, Xue, Xue, Xue, Xue, Xue, Xue, Xue, Xue, Xue, Xue, Xue, Xue, Xue, Xue, Xue, Xue, Xue, Xue, Xue, Xue, Xue, Xue, Xue, Xue, Xue, Xue, Xue, Xue, Xue, Xue, Xue, Xue, Xue, Xue, Xue, Xue, Xue
Xue, Xue, Xue, Xue, Xue, Xue, Xue, Xue, Xue, Xue, Xue, Xue, Xue, Xue, Xue, Xue, Xue, Xue, Xue, Xue, Xue, Xue, Uu, Xue, Uu^Uf, Xue, Xue, Xue, Xue, Xue, Xue, Xue, Xue, Xue, Xue, Xue, Xue, Xue, Xue, Xue, Xue, Xue, Xue, Xue, Xue, Xue
Xue, Xue, Xue, Xue, Xue, Xue, Xue, Xue, Xue, Xue, Xue, Xue, Xue, Xue, Xue, Xue, Xue, Xue, Xue, Xue, Uu, Uu^Uf, Qlf, Uu, Qlf, Uu, Uu, Xue, Uu, Xue, Xue, Xue, Uue, Uue, Uue, Xue, Uue, Xue, Xue, Xue, Xue, Xue, Xue, Xue, Xue, Xue
Xue, Xue, Xue, Xue, Uue, Xue, Uue, Uue, Uue, Uue, Uue, Xue, Xue, Xue, Qlf, Qlf, Qlf, Qlf, Qlf, Qlf, Qlf^Bsb|, Qlf, Xue, Qlf, Qlf, Qlf, Qlf, Uu^Uf, Qlf, Uu, Uu^Es, Uue, Uue^Es, Uue^Uf, Uue^Uf, Uue, Uue^Uf, Uue, Uue, Xue, Xue, Xue, Xue, Xue, Xue, Xue
Xue, Xue, Xue, Uue, Uue^Es, Uue, Uue^Es, Uue^Es, Uue, Uue^Vu, Uue, Uue, Uu, Qlf, Uu, Uu^Uf, Uu, Uu^Es, Uu^Uf, Uu, Uu, Uu, Xue, Xue, Xue, Uu, Uu, Qlf, Qlf, Qlf, Uu, Uue, Uue, Uue^Vu, Co, Uue^Uf, Uue^Uf, Uue, Uue, Xue, Xue, Xue, Xue, Xue, Xue, Xue
Xue, Xue, Xue, Uue, Uue, Uue, Uue^Uf, Uue, Uue, Uue, Xue, Xue, Xue, Uu, Xue, Xue, Xue, Xue, Xue, Xue, Xue, Xue, Xue, Xue, Xue, Uu, Xue, Xue, Xue, Qlf, Uu, Uue^Uf, Ur, Ur, Uue, 3 Ko, Co, Uue^Uf, Uue, Uue, Xue, Xue, Xue, Xue, Xue, Xue
Xue, Xue, Xue, Uue, Uue^Uf, Uue^Uf, Uue^Uf, Uue^Uf, Uue, Uue, Xue, Xue, Xue, Xue, Xue, Xue, Rb, Xue, Rb, Xue, Rb, Xue, Xue, Xue, Xue, Xue, Xue, Xue, Xue, Uu, Uue^Uf, Uue^Uf, Ur, Uue, Uue, Uue, Uue^Vu, Urb, Urb, Uue, Xue, Xue, Xue, Xue, Xue, Xue
Xue, Xue, Xue, Uue, Uue, Uue^Uf, Uue^Es, Uue, Uue^Es, Uue, Uue, Uue, Uue, Xue, Rb, Rb, Rb, Rb, Rb^Fetd, Rb^Dr, Rb^Dr, Rb, Rb, Xue, Xue, Xue, Xue, Xue, Uue, Uue, Uue, Uue^Uf, Ur, Uue^Uf, Uue, Uue, Uue, Urb, Urb^Uf, Uue, Xue, Xue, Xue, Xue, Xue, Xue
Xue, Xue, Xue, Uue, Uue^Vu, Uue, Uue, Uue, Xue, Uue, Uue, Uue, Uue, Rb, Rb, Rb, Rb^Uf, Rb^Uf, Rb^Fetd, Rb^Dr, Rb^Dr, Rb, Rb, Rb^Vu, Rb, Rb, Rb, Uue, Uue, Uue, Uue, Uue^Vu, Ur, Uue, Uue^Uf, Uue, Uue^Uf, Urb, Urb, Urb, Xue, Xue, Xue, Xue, Xue, Xue
Xue, Xue, Xue, Uue, Uue^Uf, Uue, Uue, Xue, Xue, Xue, Xue, Uue, Rb, Rb, Rb, Rb, Rb^Uf, Rb^Uf, Rb^Es, Rb^Dr, Rb^Dr, Rb^Uf, Rb^Uf, Rb, Rb^Dr, Rb^Dr, Rb^Dr, Rb, Rb, Uue^Es, Ur, Ur, Uue, Uue, Uue, Uue^Uf, Uue, Uue, Urb, Urb, Xue, Xue, Xue, Xue, Xue, Xue
Xue, Xue, Xue, Uue, Uue^Uf, Uue^Uf, Uue, Xue, Xue, Xue, Xue, Rb, Rb^Uf, Rb^Uf, Rb, Rb, Rb, Rb^Es, Rb, Rb, Rb, Rb^Uf, Rb^Uf, Rb, Rb^Dr, Rb^Dr, Rb, Rb^Es, Rb, Rb, Rb, Uue, Xue, Uue, Xue, Uue, Xue, Xue, Xue, Urb, Xue, Xue, Xue, Xue, Xue, Xue
Xue, Xue, Xue, Uue, Uue, Uue, Uue, Xue, Xue, Xue, Xue, Rb^Uf, Rb^Uf, Rb, Rb^Vu, Rb, Rb, Rb, Rb^Es, Rb, Rb, Rb^Uf, Rb, Rb, Rb^Es, Rb^Dr, Rb^Vu, Rb, Rb, Rb^Es, Rb, Rb, Rb, Xue, Xue, Xue, Xue, Xue, Xue, Urb, Urb, Xue, Xue, Xue, Xue, Xue
Xue, Xue, Xue, Uue, Uue, Uue, Xue, Xue, Xue, Xue, Xue, Rb, Rb, Rb, Rb, Rb^Uf, Rb^Uf, Rb^Fetd, Rb^Fetd, Rb, Rb, Rb, Rb, Rb, Rb^Vct, Rb^Es, Rb, Rb, Rb^Uf, Rb, Rb^Fetd, Rb^Fetd, Rb, Rb, Rb, Xue, Xue, Xue, Xue, Urb, Urb, Xue, Xue, Xue, Uue^Vu, Xue
Xue, Xue, Xue, Uue^Es, Uue, Uue^Es, Xue, Xue, Xue, Xue, Xue, Rb, Rb, Rb, Rb^Uf, Rb^Uf, Rb, Rb^Fetd, Rb, Rb, Rb^Vu, Rb^Uf, Rb^Uf, Ce, Ce^Es, Ce, Rb^Uf, Rb^Uf, Rb^Uf, Rb, Rb, Rb^Fetd, Rb, Rb^Uf, Rb, Xue, Xue, Xue, Xue, Urb, Urb, Ql, Ql, Uue, Uue, Uue
Xue, Xue, Xue, Uue, Uue, Uue, Uue, Xue, Xue, Xue, Xue, Rb, Rb^Fetd, Rb^Fetd, Rb, Rb^Uf, Rb, Rb, Rb^Es, Rb, Rb, Rb^Uf, Ce^Es, Ce, 1 Ke, Ce, Ce^Es, Rb^Uf, Rb, Qxua, Qxua, Rb^Dr, Rb^Uf, Rb^Uf, Rb^Uf, Xue, Xue, Xue, Xue, Urb, Urb, Ql, Ql, Ql, Xue, Uue
Xue, Xue, Xue, Xue, Uue^Vu, Uue, Uue^Uf, Xue, Xue, Xue, Xue, Rb, Rb, Rb, Rb, Rb^Dr, Rb^Dr, Rb, Rb, Rb, Rb^Uf, Rb, Rb^Vct, Ce, Ce^Es, Ce, Rb^Vct, Rb, Rb, Qxua, Rb, Rb, Rb^Fetd, Rb, Rb, Xue, Xue, Xue, Xue, Urb, Urb, Ql, Ql, Ql, Xue, Xue
Xue, Xue, Xue, Xue, Xue, Uue^Uf, Uue, Xue, Xue, Xue, Xue, Rb, Rb, Rb^Vu, Rb, Rb^Dr, Rb, Rb, Rb^Es, Rb, Rb^Uf, Rb^Dr, Rb^Dr, Ce^Es, Rb, Ce, Rb, Rb^Vu, Qxua, Qxua, Rb, Rb^Fetd, Rb^Fetd, Rb, Rb^Vu, Xue, Xue, Xue, Xue, Urb, Urb, Ql, Xue, Xue, Xue, Xue
Xue, Xue, Xue, Xue, Xue, Uue, Uue, Xue, Xue, Xue, Xue, Rb, Rb, Rb, Rb, Rb, Rb^Uf, Rb, Rb, Rb, Rb^Fetd, Rb, Rb, Rb, Rb, Rb^Es, Qxua, Qxua, Qxua, Rb^Uf, Rb^Uf, Rb, Rb^Dr, Rb, Rb, Xue, Xue, Xue, Xue, Xue, Urb, Urb, Urb, Xue, Xue, Xue
Xue, Xue, Xue, Xue, Xue, Uue, Uue, Xue, Xue, Xue, Xue, Xue, Xue, Rb, Rb^Uf, Rb^Uf, Rb^Uf, Rb, Rb, Rb^Fetd, Rb^Fetd, Rb, Rb^Es, Rb, Qxua, Qxua, Qxua, Qxua, Rb^Dr, Rb^Uf, Rb, Rb^Es, Rb^Dr, Rb^Dr, Rb, Xue, Xue, Xue, Xue, Xue, Xue, Urb, Urb, Xue, Xue, Xue
Xue, Xue, Xue, Xue, Xue, Xue, Uue, Xue, Xue, Xue, Xue, Xue, Xue, Rb, Rb, Rb^Uf, Rb, Rb, Rb^Vu, Rb, Rb, Rb, Rb, Rb^Vu, Rb, Rb, Rb^Dr, Rb^Dr, Rb^Dr, Rb, Rb^Es, Rb, Rb^Uf, Rb^Dr, Xue, Xue, Xue, Xue, Xue, Xue, Xue, Urb, Urb, Xue, Xue, Xue
Xue, Xue, Xue, Xue, Xue, Xue, Uue^Vu, Xue, Xue, Xue, Xue, Xue, Xue, Rb, Rb, Rb, Rb^Es, Rb, Rb, Rb, Rb, Rb, Rb^Uf, Rb, Rb^Fetd, Rb^Fetd, Rb, Rb^Dr, Rb, Rb, Rb, Rb, Urb, Xue, Xue, Xue, Xue, Xue, Xue, Xue, Xue, Urb, Urb, Xue, Xue, Xue
Xue, Xue, Xue, Xue, Xue, Xue, Uue^Uf, Xue, Xue, Xue, Xue, Xue, Xue, Xue, Uue, Rb, Rb, Rb, Rb, Rb, Rb^Uf, Rb^Uf, Rb^Uf, Rb^Uf, Rb, Rb^Fetd, Rb^Es, Rb^Vu, Rb, Rb, Uue^Uf, Urb, Urb, Urb, Xue, Xue, Xue, Xue, Xue, Xue, Xue, Urb, Urb, Xue, Xue, Xue
Xue, Xue, Xue, Xue, Xue, Xue, Uue, Uue^Uf, Uue^Uf, Xue, Xue, Xue, Uue^Vu, Xue, Ur, Ur, Uue, Uue, Xue, Rb, Rb, Rb^Uf, Rb^Uf, Rb^Uf, Rb^Dr, Rb, Rb, Rb, Xue, Xue, Xue, Uue^Uf, Uue^Uf, Urb, Urb, Xue, Uue^Uf, Xue, Xue, Xue, Xue, Urb, Urb, Urb, Xue, Xue
Xue, Xue, Xue, Xue, Xue, Xue, Uue^Uf, Uue^Uf, Uue, Uue, Uue, Uue^Uf, Ur, Ur, Uue, Uue, Xue, Xue, Xue, Rb, Rb^Es, Rb, Rb, Rb, Rb^Dr, Rb^Dr, Rb^Dr, Rb, Xue, Xue, Xue, Xue, Uue^Uf, Urb^Uf, Urb, Urb, Cud, Uue^Uf, Uue^Uf, Xue, Xue, Xue, Urb, Urb, Xue, Xue
Xue, Xue, Xue, Xue, Xue, Xue, Uue^Uf, Uue, Uue^Es, Uue^Es, Ur, Ur, Xue, Xue, Xue, Xue, Xue, Xue, Xue, Rb, Rb, Rb^Vu, Rb, Rb, Xue, Rb^Dr, Xue, Xue, Xue, Xue, Xue, Xue, Uue^Uf, Uue^Uf, Urb^Uf, Urb, Cud, Uue^Uf, Urb, Uue, Uue^Vu, Xue, Urb, Urb, Xue, Xue
Xue, Xue, Xue, Xue, Xue, Xue, Uue, Uue, Ur, Ur, Uue, Uue, Xue, Xue, Xue, Xue, Xue, Xue, Xue, Xue, Xue, Rb, Xue, Xue, Xue, Xue, Xue, Xue, Xue, Xue, Xue, Xue, Uue^Uf, Uue^Uf, Uue^Uf, Cud, 2 Kud, Cud, Urb, Urb, Urb, Urb, Urb, Xue, Xue, Xue
Xue, Xue, Xue, Xue, Xue, Xue, Xue, Ur, Uue^Uf, Uue, Uue^Uf, Uue, Xue, Xue, Xue, Xue, Xue, Xue, Xue, Xue, Xue, Xue, Xue, Xue, Xue, Xue, Xue, Xue, Xue, Xue, Uue^Vu, Xue, Ur, Uue^Uf, Uue, Cud, Kud, Cud, Uue, Urb^Uf, Urb^Uf, Urb, Xue, Xue, Xue, Xue
Xue, Xue, Xue, Xue, Xue, Xue, Uue^Vu, Ur, Uue^Uf, Uue^Uf, Uue^Uf, Uue, Uue^Es, Xue, Uue, Xue, Xue, Xue, Xue, Xue, Xue, Xue, Xue, Xue, Uue^Es, Xue, Uue, Xue, Ur, Ur, Ur, Ur, Uue^Es, Ur^Es, Ur, Cud, Cud, Cud, Uue, Uue, Uue^Uf, Xue, Xue, Xue, Xue, Xue
Xue, Xue, Xue, Xue, Xue, Xue, Uue, Ur, Uue^Uf, Uue^Uf, Uue^Uf, Uue, Uue^Es, Uue, Ur, Ur, Ur, Uue, Uue, Xue, Uue, Xue, Uue^Uf, Uue, Uue, Uue, Ur, Ur, Uue, Uue^Uf, Uue^Uf, Uue^Uf, Uue^Es, Uue, Uue, Uue, Cud, Uue, Uue^Uf, Uue^Uf, Uue, Xue, Xue, Xue, Xue, Xue
Xue, Xue, Xue, Xue, Xue, Xue, Uue, Ur, Ur, Uue, Uue^Vu, Uue, Ur, Ur, Xue, Xue, Ur, Uue^Vu, Xue, Uue, Xue, Uue^Uf, Xue, Uue^Uf, Xue, Uue, Ur, Uue, Xue, Uue^Uf, Uue^Uf, Uue^Uf, Uue, Uue, Uue^Vu, Uue, Uue^Es, Uue, Uue, Uue^Uf, Xue, Xue, Xue, Xue, Xue, Xue
Xue, Xue, Xue, Xue, Uue, Uue, Uue, Uue^Es, Uue, Ur, Ur, Ur, Uue, Uue, Uue, Uue, Uue, Ur, Ur, Xue, Uue^Uf, Uue^Uf, Uue, Xue, Uue, Uue^Vu, Ur, Xue, Uue, Uue, Uue, Uue, Uue, Uue, Uue, Uue, Uue, Uue, Uue, Uue, Xue, Xue, Xue, Xue, Xue, Xue
Xue, Xue, Xue, Uue, Uue, Uue, Uue, Uue, Xue, Xue, Xue, Xue, Xue, Uue, Xue, Uue, Xue, Uue, Uue, Ur, Ur, Ur, Ur, Ur, Ur, Ur, Xue, Uue, Xue, Uue, Xue, Xue, Xue, Uue, Xue, Uue, Xue, Xue, Uue, Uue, Xue, Xue, Xue, Xue, Xue, Xue
Xue, Xue, Uue, Uue, Uue, Uue, Xue, Xue, Xue, Xue, Xue, Xue, Xue, Xue, Xue, Xue, Xue, Xue, Xue, Xue, Xue, Uue, Xue, Uue, Xue, Xue, Xue, Xue, Xue, Xue, Xue, Xue, Xue, Xue, Xue, Xue, Xue, Xue, Uue, Uue, Xue, Xue, Xue, Xue, Xue, Xue
Xue, Uue, Uue, Uue, Xue, Xue, Xue, Xue, Xue, Xue, Xue, Xue, Xue, Xue, Xue, Xue, Xue, Xue, Xue, Xue, Xue, Xue, Xue, Xue, Xue, Xue, Xue, Xue, Xue, Xue, Xue, Xue, Xue, Xue, Xue, Xue, Uue, Uue, Uue, Uue, Xue, Xue, Xue, Xue, Xue, Xue
Xue, Uue, Uue, Xue, Xue, Xue, Xue, Xue, Xue, Xue, Xue, Xue, Xue, Xue, Xue, Xue, Xue, Xue, Xue, Xue, Xue, Xue, Xue, Xue, Xue, Xue, Xue, Xue, Xue, Xue, Xue, Xue, Xue, Xue, Xue, Xue, Uue, Uue, Uue, Uue, Xue, Xue, Xue, Xue, Xue, Xue
