border_size=1
usage=map

Xue         , Xue         , Xue         , Xue         , Xue         , Xue         , Xue         , Xue         , Xue         , Xue         , Xue         , Xue         , Xue         , Xue         , Xue         , Xue         , Xue         , Xue         , Xue         , Xue         , Xue         , Xue         , Xue         , Xue         , Xue         , Xue         , Xue         , Xue         , Xue         , Xue         , Xue         , Xue         , Xue         , Xue         , Xue         , Xue         , Xue         , Xue         , Xue         , Xue         , Xue         , Xue         , Xue         , Xue         , Xue         , Xue         
Xue         , Xue         , Xue         , Xue         , Xue         , Xue         , Xue         , Xue         , Xue         , Xue         , Xue         , Xue         , Xue         , Xue         , Xue         , Xue         , Xue         , Xue         , Xue         , Xue         , Xue         , Xue         , Uu          , Xue         , Uu^Uf       , Xue         , Xue         , Xue         , Xue         , Xue         , Xue         , Xue         , Xue         , Xue         , Xue         , Xue         , Xue         , Xue         , Xue         , Xue         , Xue         , Xue         , Xue         , Xue         , Xue         , Xue         
Xue         , Xue         , Xue         , Xue         , Xue         , Xue         , Xue         , Xue         , Xue         , Xue         , Xue         , Xue         , Xue         , Xue         , Xue         , Xue         , Xue         , Xue         , Xue         , Xue         , Uu          , Uu^Uf       , Qlf         , Uu          , Qlf         , Uu          , Uu          , Xue         , Uu          , Xue         , Xue         , Xue         , Uue         , Uue         , Uue         , Xue         , Uue         , Xue         , Xue         , Xue         , Xue         , Xue         , Xue         , Xue         , Xue         , Xue         
Xue         , Xue         , Xue         , Xue         , Uue         , Xue         , Uue         , Uue         , Uue         , Uue         , Uue         , Xue         , Xue         , Xue         , Qlf         , Qlf         , Qlf         , Qlf         , Qlf         , Qlf         , Qlf^Bsb|    , Qlf         , Xue         , Qlf         , Qlf         , Qlf         , Qlf         , Uu^Uf       , Qlf         , Uu          , Uu^Es       , Uue         , Uue^Es      , Uue^Uf      , Uue^Uf      , Uue         , Uue^Uf      , Uue         , Uue         , Xue         , Xue         , Xue         , Xue         , Xue         , Xue         , Xue         
Xue         , Xue         , Xue         , Uue         , Uue^Es      , Uue         , Uue^Es      , Uue^Es      , Uue         , Uue^Vu      , Uue         , Uue         , Uu          , Qlf         , Uu          , Uu^Uf       , Uu          , Uu^Es       , Uu^Uf       , Uu          , Uu          , Xue         , Xue         , Xue         , Xue         , Xue         , Xue         , Qlf         , Qlf         , Qlf         , Uu          , Uue         , Uue         , Uue^Vu      , Co          , Uue^Uf      , Uue^Uf      , Uue         , Uue         , Xue         , Xue         , Xue         , Xue         , Xue         , Xue         , Xue         
Xue         , Xue         , Xue         , Uue         , Uue         , Uue         , Uue^Uf      , Uue         , Uue         , Uue         , Xue         , Xue         , Xue         , Uu          , Xue         , Xue         , Xue         , Xue         , Xue         , Xue         , Xue         , Xue         , Xue         , Xue         , Xue         , Xue         , Xue         , Xue         , Xue         , Qlf         , Uu          , Uue^Uf      , Uue         , Uue         , Uue         , 3 Ko        , Co          , Uue^Uf      , Uue         , Uue         , Xue         , Xue         , Xue         , Xue         , Xue         , Xue         
Xue         , Xue         , Xue         , Uue         , Uue^Uf      , Uue^Uf      , Uue^Uf      , Uue^Uf      , Uue         , Uue         , Xue         , Xue         , Xue         , Xue         , Xue         , Xue         , Rb          , Xue         , Rb          , Xue         , Rb          , Xue         , Xue         , Xue         , Xue         , Xue         , Xue         , Xue         , Xue         , Uu          , Uue^Uf      , Uue^Uf      , Uue         , Uue         , Uue         , Uue         , Uue^Vu      , Uue         , Uue         , Uue         , Xue         , Xue         , Xue         , Xue         , Xue         , Xue         
Xue         , Xue         , Xue         , Uue         , Uue         , Uue^Uf      , Uue^Es      , Uue         , Uue^Es      , Uue         , Uue         , Uue         , Uue         , Xue         , Rb          , Rb          , Rb          , Ce          , Ce^Es       , Ce          , Rb          , Rb          , Rb          , Xue         , Xue         , Xue         , Xue         , Xue         , Uue         , Uue         , Uue         , Uue^Uf      , Uue         , Uue^Uf      , Uue         , Uue         , Uue         , Uue         , Uue^Uf      , Uue         , Xue         , Xue         , Xue         , Xue         , Xue         , Xue         
Xue         , Xue         , Xue         , Uue         , Uue^Vu      , Uue         , Uue         , Uue         , Xue         , Uue         , Uue         , Uue         , Uue         , Rb          , Rb          , Rb          , Ce^Es       , Ce          , 1 Ke        , Ce          , Ce^Es       , Rb          , Rb          , Rb^Vu       , Rb          , Rb          , Rb          , Uue         , Uue         , Uue         , Uue         , Uue^Vu      , Uue         , Uue         , Uue^Uf      , Uue         , Uue^Uf      , Uue         , Uue         , Uue         , Xue         , Xue         , Xue         , Xue         , Xue         , Xue         
Xue         , Xue         , Xue         , Uue         , Uue^Uf      , Uue         , Uue         , Xue         , Xue         , Xue         , Xue         , Uue         , Rb          , Rb          , Rb          , Rb          , Rb          , Ce          , Ce^Es       , Ce          , Rb          , Rb          , Rb          , Rb          , Rb          , Rb          , Rb          , Rb          , Rb          , Uue^Es      , Uue         , Uue         , Uue         , Uue         , Uue         , Uue^Uf      , Uue         , Uue         , Xue         , Xue         , Xue         , Xue         , Xue         , Xue         , Xue         , Xue         
Xue         , Xue         , Xue         , Uue         , Uue^Uf      , Uue^Uf      , Uue         , Xue         , Xue         , Xue         , Xue         , Rb          , Rb^Uf       , Rb^Uf       , Rb          , Rb          , Rb          , Ce^Es       , Rb          , Ce          , Rb          , Rb          , Rb          , Rb          , Rb^Dr       , Rb          , Rb          , Rb^Es       , Rb          , Rb          , Rb          , Uue         , Xue         , Uue         , Xue         , Uue         , Xue         , Xue         , Xue         , Xue         , Xue         , Xue         , Xue         , Xue         , Xue         , Xue         
Xue         , Xue         , Xue         , Uue         , Uue         , Uue         , Uue         , Xue         , Xue         , Xue         , Xue         , Rb^Uf       , Rb^Uf       , Rb          , Rb^Vu       , Rb          , Rb          , Rb          , Rb^Es       , Rb          , Rb          , Rb^Es       , Rb          , Rb          , Rb^Es       , Rb^Dr       , Rb^Vu       , Rb          , Rb          , Rb^Es       , Rb          , Rb          , Rb          , Xue         , Xue         , Xue         , Xue         , Xue         , Xue         , Xue         , Xue         , Xue         , Xue         , Xue         , Xue         , Xue         
Xue         , Xue         , Xue         , Uue         , Uue         , Uue         , Xue         , Xue         , Xue         , Xue         , Xue         , Rb          , Rb          , Rb          , Rb          , Rb          , Rb          , Rb          , Rb          , Rb          , Rb          , Rb          , Rb          , Rb          , Rb          , Rb^Es       , Rb          , Rb          , Rb^Uf       , Rb          , Rb          , Rb          , Rb          , Rb          , Rb          , Xue         , Xue         , Xue         , Xue         , Xue         , Xue         , Xue         , Xue         , Xue         , Xue         , Xue         
Xue         , Xue         , Xue         , Uue^Es      , Uue         , Uue^Es      , Xue         , Xue         , Xue         , Xue         , Xue         , Rb          , Rb          , Rb          , Rb          , Rb          , Rb          , Rb^Fetd     , Rb          , Rb          , Rb^Vu       , Rb^Uf       , Rb^Uf       , Rb          , Rb          , Rb          , Rb^Uf       , Rb^Uf       , Rb^Uf       , Rb          , Rb          , Rb^Fetd     , Rb          , Rb^Uf       , Rb          , Xue         , Xue         , Xue         , Xue         , Xue         , Xue         , Xue         , Xue         , Xue         , Xue         , Xue         
Xue         , Xue         , Xue         , Uue         , Uue         , Uue         , Uue         , Xue         , Xue         , Xue         , Xue         , Rb          , Rb          , Rb^Fetd     , Rb          , Rb^Es       , Rb          , Rb          , Rb^Es       , Rb          , Rb          , Rb^Uf       , Rb          , Rb          , Rb^Fetd     , Rb          , Rb          , Rb^Uf       , Rb          , Qxua        , Qxua        , Rb^Dr       , Rb^Uf       , Rb^Uf       , Rb^Uf       , Xue         , Xue         , Xue         , Xue         , Xue         , Xue         , Xue         , Xue         , Xue         , Xue         , Xue         
Xue         , Xue         , Xue         , Xue         , Uue^Vu      , Uue         , Uue^Uf      , Xue         , Xue         , Xue         , Xue         , Rb          , Rb          , Rb          , Rb          , Rb^Dr       , Rb^Dr       , Rb          , Rb          , Rb          , Rb          , Rb          , Rb          , Rb          , Rb          , Rb          , Rb^Es       , Rb          , Rb          , Qxua        , Rb          , Rb          , Rb          , Rb          , Rb          , Xue         , Xue         , Xue         , Xue         , Xue         , Xue         , Xue         , Xue         , Xue         , Xue         , Xue         
Xue         , Xue         , Xue         , Xue         , Xue         , Uue^Uf      , Uue         , Xue         , Xue         , Xue         , Xue         , Rb          , Rb          , Rb^Vu       , Rb          , Rb^Dr       , Rb          , Rb          , Rb^Es       , Rb          , Rb          , Rb^Dr       , Rb^Dr       , Rb^Dr       , Rb          , Rb^Es       , Rb          , Rb^Vu       , Qxua        , Qxua        , Rb          , Rb^Fetd     , Rb^Es       , Rb          , Rb^Vu       , Xue         , Xue         , Xue         , Xue         , Xue         , Xue         , Xue         , Xue         , Xue         , Xue         , Xue         
Xue         , Xue         , Xue         , Xue         , Xue         , Uue         , Uue         , Xue         , Xue         , Xue         , Xue         , Rb          , Rb          , Rb          , Rb          , Rb          , Rb^Uf       , Rb          , Rb          , Rb          , Rb          , Rb          , Rb          , Rb          , Rb          , Rb^Es       , Qxua        , Qxua        , Qxua        , Rb^Es       , Rb          , Rb          , Rb          , Rb          , Rb          , Xue         , Xue         , Xue         , Xue         , Xue         , Xue         , Xue         , Xue         , Xue         , Xue         , Xue         
Xue         , Xue         , Xue         , Xue         , Xue         , Uue         , Uue         , Xue         , Xue         , Xue         , Xue         , Xue         , Xue         , Rb          , Rb^Uf       , Rb^Uf       , Rb^Uf       , Rb          , Rb          , Rb          , Rb^Fetd     , Rb          , Rb^Es       , Rb          , Qxua        , Qxua        , Qxua        , Qxua        , Rb          , Rb          , Rb          , Rb^Es       , Rb^Dr       , Rb          , Rb          , Xue         , Xue         , Xue         , Xue         , Xue         , Xue         , Xue         , Xue         , Xue         , Xue         , Xue         
Xue         , Xue         , Xue         , Xue         , Xue         , Xue         , Uue         , Xue         , Xue         , Xue         , Xue         , Xue         , Xue         , Rb          , Rb          , Rb^Uf       , Rb          , Rb          , Rb^Vu       , Rb          , Rb          , Rb          , Rb          , Rb^Vu       , Rb          , Rb          , Rb^Dr       , Rb          , Rb          , Rb          , Rb^Es       , Rb          , Rb          , Rb          , Xue         , Xue         , Xue         , Xue         , Xue         , Xue         , Xue         , Xue         , Xue         , Xue         , Xue         , Xue         
Xue         , Xue         , Xue         , Xue         , Xue         , Xue         , Uue^Vu      , Xue         , Xue         , Xue         , Xue         , Xue         , Xue         , Rb          , Rb          , Rb          , Rb^Es       , Rb          , Rb          , Rb          , Rb          , Rb          , Rb^Uf       , Rb          , Rb          , Rb          , Rb          , Rb^Dr       , Rb          , Rb          , Rb          , Rb          , Xue         , Xue         , Xue         , Xue         , Xue         , Xue         , Xue         , Xue         , Xue         , Xue         , Xue         , Xue         , Xue         , Xue         
Xue         , Xue         , Xue         , Xue         , Xue         , Xue         , Uue^Uf      , Xue         , Xue         , Xue         , Xue         , Xue         , Xue         , Xue         , Uue         , Rb          , Rb          , Rb          , Rb          , Rb          , Rb^Uf       , Rb^Uf       , Rb^Uf       , Rb^Uf       , Rb          , Rb^Fetd     , Rb^Es       , Rb^Vu       , Rb          , Rb          , Xue         , Uue         , Uue         , Xue         , Xue         , Xue         , Xue         , Xue         , Xue         , Xue         , Xue         , Xue         , Xue         , Xue         , Xue         , Xue         
Xue         , Xue         , Xue         , Xue         , Xue         , Xue         , Uue         , Uue^Uf      , Uue^Uf      , Xue         , Xue         , Xue         , Uue^Vu      , Xue         , Uue         , Uue         , Uue         , Uue         , Xue         , Rb          , Rb          , Rb^Uf       , Rb^Uf       , Rb^Uf       , Rb          , Rb          , Rb          , Rb          , Xue         , Xue         , Xue         , Xue         , Uue         , Uue         , Uue         , Uue^Es      , Uue         , Xue         , Xue         , Xue         , Xue         , Xue         , Xue         , Xue         , Xue         , Xue         
Xue         , Xue         , Xue         , Xue         , Xue         , Xue         , Uue^Uf      , Uue^Uf      , Uue         , Uue         , Uue         , Uue         , Uue         , Uue         , Uue         , Uue         , Xue         , Xue         , Xue         , Rb          , Rb^Es       , Rb          , Rb          , Rb          , Rb^Es       , Rb          , Rb          , Rb          , Xue         , Xue         , Xue         , Xue         , Uue^Uf      , Uue^Uf      , Uue         , Uue         , Cud         , Uue         , Uue^Es      , Xue         , Xue         , Xue         , Xue         , Xue         , Xue         , Xue         
Xue         , Xue         , Xue         , Xue         , Xue         , Xue         , Uue^Uf      , Uue         , Uue^Es      , Uue^Es      , Uue         , Uue         , Xue         , Xue         , Xue         , Xue         , Xue         , Xue         , Xue         , Rb          , Rb          , Rb^Vu       , Rb          , Rb          , Xue         , Rb          , Xue         , Xue         , Xue         , Xue         , Xue         , Xue         , Uue         , Uue^Uf      , Uue^Uf      , Uue         , Cud         , Uue         , Uue         , Uue         , Uue^Vu      , Xue         , Xue         , Xue         , Xue         , Xue         
Xue         , Xue         , Xue         , Xue         , Xue         , Xue         , Uue         , Uue         , Uue         , Uue         , Uue         , Uue         , Xue         , Xue         , Xue         , Xue         , Xue         , Xue         , Xue         , Xue         , Xue         , Rb          , Xue         , Xue         , Xue         , Xue         , Xue         , Xue         , Xue         , Xue         , Xue         , Xue         , Uue         , Uue         , Uue^Uf      , Cud         , 2 Kud       , Cud         , Uue         , Uue         , Uue         , Xue         , Xue         , Xue         , Xue         , Xue         
Xue         , Xue         , Xue         , Xue         , Xue         , Xue         , Xue         , Uue         , Uue^Uf      , Uue         , Uue^Uf      , Uue         , Xue         , Xue         , Xue         , Xue         , Xue         , Xue         , Xue         , Xue         , Xue         , Xue         , Xue         , Xue         , Xue         , Xue         , Xue         , Xue         , Xue         , Xue         , Uue^Vu      , Xue         , Uue         , Uue^Uf      , Uue         , Cud         , Cud         , Cud         , Uue         , Uue^Uf      , Uue^Uf      , Xue         , Xue         , Xue         , Xue         , Xue         
Xue         , Xue         , Xue         , Xue         , Xue         , Xue         , Uue^Vu      , Uue         , Uue^Uf      , Uue^Uf      , Uue^Uf      , Uue         , Uue^Es      , Xue         , Uue         , Xue         , Xue         , Xue         , Xue         , Xue         , Xue         , Xue         , Xue         , Xue         , Uue^Es      , Xue         , Uue         , Xue         , Uue         , Uue         , Uue         , Uue         , Uue^Es      , Uue^Es      , Uue         , Uue         , Cud         , Uue         , Uue         , Uue         , Uue^Uf      , Xue         , Xue         , Xue         , Xue         , Xue         
Xue         , Xue         , Xue         , Xue         , Xue         , Xue         , Uue         , Uue         , Uue^Uf      , Uue^Uf      , Uue^Uf      , Uue         , Uue^Es      , Uue         , Uue         , Uue         , Uue         , Uue         , Uue         , Xue         , Uue         , Xue         , Uue^Uf      , Uue         , Uue         , Uue         , Uue         , Uue         , Uue         , Uue^Uf      , Uue^Uf      , Uue^Uf      , Uue^Es      , Uue         , Uue         , Uue         , Uue         , Uue         , Uue^Uf      , Uue^Uf      , Uue         , Xue         , Xue         , Xue         , Xue         , Xue         
Xue         , Xue         , Xue         , Xue         , Xue         , Xue         , Uue         , Uue         , Uue         , Uue         , Uue^Vu      , Uue         , Uue         , Uue         , Xue         , Xue         , Uue         , Uue^Vu      , Xue         , Uue         , Xue         , Uue^Uf      , Xue         , Uue^Uf      , Xue         , Uue         , Uue         , Uue         , Xue         , Uue^Uf      , Uue^Uf      , Uue^Uf      , Uue         , Uue         , Uue^Vu      , Uue         , Uue^Es      , Uue         , Uue         , Uue^Uf      , Xue         , Xue         , Xue         , Xue         , Xue         , Xue         
Xue         , Xue         , Xue         , Xue         , Xue         , Xue         , Uue         , Uue^Es      , Uue         , Uue         , Uue         , Uue         , Uue         , Uue         , Uue         , Uue         , Uue         , Uue         , Uue         , Xue         , Uue^Uf      , Uue^Uf      , Uue         , Xue         , Uue         , Uue^Vu      , Uue         , Xue         , Uue         , Uue         , Uue         , Uue         , Uue         , Uue         , Uue         , Uue         , Uue         , Uue         , Xue         , Xue         , Xue         , Xue         , Xue         , Xue         , Xue         , Xue         
Xue         , Xue         , Xue         , Xue         , Xue         , Xue         , Xue         , Uue         , Xue         , Xue         , Xue         , Xue         , Xue         , Uue         , Xue         , Uue         , Xue         , Uue         , Uue         , Uue         , Uue         , Uue         , Uue         , Uue         , Uue         , Uue         , Xue         , Uue         , Xue         , Uue         , Xue         , Xue         , Xue         , Uue         , Xue         , Uue         , Xue         , Xue         , Xue         , Xue         , Xue         , Xue         , Xue         , Xue         , Xue         , Xue         
Xue         , Xue         , Xue         , Xue         , Xue         , Xue         , Xue         , Xue         , Xue         , Xue         , Xue         , Xue         , Xue         , Xue         , Xue         , Xue         , Xue         , Xue         , Xue         , Xue         , Xue         , Uue         , Xue         , Uue         , Xue         , Xue         , Xue         , Xue         , Xue         , Xue         , Xue         , Xue         , Xue         , Xue         , Xue         , Xue         , Xue         , Xue         , Xue         , Xue         , Xue         , Xue         , Xue         , Xue         , Xue         , Xue         
Xue         , Xue         , Xue         , Xue         , Xue         , Xue         , Xue         , Xue         , Xue         , Xue         , Xue         , Xue         , Xue         , Xue         , Xue         , Xue         , Xue         , Xue         , Xue         , Xue         , Xue         , Xue         , Xue         , Xue         , Xue         , Xue         , Xue         , Xue         , Xue         , Xue         , Xue         , Xue         , Xue         , Xue         , Xue         , Xue         , Xue         , Xue         , Xue         , Xue         , Xue         , Xue         , Xue         , Xue         , Xue         , Xue         
Xue         , Xue         , Xue         , Xue         , Xue         , Xue         , Xue         , Xue         , Xue         , Xue         , Xue         , Xue         , Xue         , Xue         , Xue         , Xue         , Xue         , Xue         , Xue         , Xue         , Xue         , Xue         , Xue         , Xue         , Xue         , Xue         , Xue         , Xue         , Xue         , Xue         , Xue         , Xue         , Xue         , Xue         , Xue         , Xue         , Xue         , Xue         , Xue         , Xue         , Xue         , Xue         , Xue         , Xue         , Xue         , Xue         
