border_size=1
usage=map

Gg          , Gg          , Gg          , Gg          , Gg          , Gg          , Gg          , Gg          , Gg          , Gg          , Gg          , Gg          , Gg          , Gg          , Gg          , Gg          , Gg          , Gg          , Gg          , Gg          
Gg          , 2 Ko        , Co          , Gg          , Gg          , Gg          , Gg          , Gg          , Gg          , Gg          , Gg          , Gg          , Gg          , Gg          , Gg          , Gg          , Gg          , Gg          , Gg          , Gg          
Gg          , Co          , Co          , Gg          , Gg          , Gg          , Gg          , Gg          , Gg          , Gg          , Cv          , Cv          , Cv          , Gg          , Gg          , Gg          , Gg          , Gg          , Gg          , Gg          
Gg          , Co          , Gg          , Gg          , Gg          , Gg          , Gg          , Gg          , Cv          , Cv          , Cv          , Cv          , Cv          , Cv          , Cv          , Gg          , Gg          , Gg          , Gg          , Gg          
Gg          , Gg          , Gg          , Gg          , Gg          , Gg          , Cv          , Cv          , Cv          , Cv          , Cv          , Cv          , Cv          , Cv          , Cv          , Cv          , Cv          , Gg          , Gg          , Gg          
Gg          , Gg          , Gg          , Gg          , Gg          , Gg          , Cv          , Cv          , Gg^Fet      , Cv          , Cv          , Cv          , Cv          , Cv          , Gg^Fet      , Cv          , Cv          , Gg          , Gg          , Gg          
Gg          , Gg          , Gg          , Gg          , Gg          , Gg          , Cv          , Cv          , Cv          , Cv          , Cv          , Cv          , Cv          , Cv          , Cv          , Cv          , Cv          , Gg          , Gg          , Gg          
Gg          , Gg          , Gg          , Gg          , Gg          , Gg          , Cv          , Cv          , Cv          , Cv          , Cv          , Cv          , Cv          , Cv          , Cv          , Cv          , Cv          , Gg          , Gg          , Gg          
Gg          , Gg          , Gg          , Gg          , Cv          , Cv          , Cv          , Cv          , Cv          , Cv          , Cv          , Cv          , Cv          , Cv          , Cv          , Cv          , Cv          , Cv          , Cv          , Gg          
Gg          , Gg          , Gg          , Gg          , Cv          , Gg^Fet      , Cv          , Cv          , Cv          , Cv          , Cv          , Cv          , Cv          , Gg^Fet      , Cv          , Cv          , Cv          , Cv          , Cv          , Gg          
Gg          , Gg          , Gg          , Gg          , Cv          , Cv          , Cv          , Cv          , Cv          , Cv          , Cv          , Cv          , Cv          , Cv          , Cv          , Cv          , Cv          , Cv          , Cv          , Gg          
Gg          , Gg          , Gg          , Gg          , Gg          , Cv          , Cv          , Cv          , Cv          , Cv          , Cv          , Cv          , Cv          , Cv          , Cv          , Cv          , Cv          , Cv          , Gg          , Gg          
Gg          , Gg          , Gg          , Gg          , Gg          , Gg          , Gg          , Cv          , Cv          , Gg^Fet      , Cv          , Cv          , Cv          , Cv          , Cv          , Cv          , Gg          , Gg          , Gg          , Gg          
Gg          , Gg          , Gg          , Gg          , Gg          , Gg          , Gg          , Cv          , Cv          , Cv          , Cv          , Cv          , Cv          , Cv          , Cv          , Cv          , Gg          , Gg          , Gg          , Gg          
Gg          , Gg          , Gg          , Gg          , Gg          , Gg          , Cv          , Cv          , Cv          , Cv          , Cv          , Cv          , Cv          , Cv          , Cv          , Cv          , Cv          , Gg          , Gg          , Gg          
Gg          , Gg          , Gg          , Gg          , Cv          , Cv          , Cv          , Cv          , Cv          , Cv          , Cv          , Cv          , Cv          , Gg^Fet      , Cv          , Cv          , Cv          , Cv          , Cv          , Gg          
Gg          , Gg          , Gg          , Gg          , Cv          , Cv          , Cv          , Cv          , Gg^Fet      , Cv          , Cv          , Cv          , Cv          , Cv          , Cv          , Cv          , Cv          , Cv          , Cv          , Gg          
Gg          , Gg          , Gg          , Gg          , Cv          , Cv          , Cv          , Cv          , Cv          , Cv          , Cv          , Cv          , Cv          , Cv          , Cv          , Cv          , Cv          , Cv          , Cv          , Gg          
Gg          , Gg          , Gg          , Gg          , Gg          , Cv          , Cv          , Cv          , Gg          , Cv          , Cv          , Cv          , Cv          , Cv          , Gg          , Cv          , Cv          , Cv          , Gg          , Gg          
Gg          , Gg          , Gg          , Gg          , Gg          , Gg          , Gg          , Gg          , Gg          , Gg          , Gg          , 1 Kv        , Gg          , Gg          , Gg          , Gg          , Gg          , Gg          , Gg          , Gg          
Gg          , Gg          , Gg          , Gg          , Gg          , Gg          , Gg          , Gg          , Gg          , Gg          , Gg          , Gg          , Gg          , Gg          , Gg          , Gg          , Gg          , Gg          , Gg          , Gg          
Gg          , Gg          , Gg          , Gg          , Gg          , Gg          , Gg          , Gg          , Gg          , Gg          , Gg          , Gg          , Gg          , Gg          , Gg          , Gg          , Gg          , Gg          , Gg          , Gg          
