border_size=1
usage=map

Xue         , Xue         , Xue         , Xue         , Xue         , Xue         , Xue         , Xue         , Xue         , Xue         , Xue         , Xue         , Xue         , Xue         , Xue         , Xue         , Xue         , Xue         , Xue         , Xue         , Xue         , Xue         , Xue         , Xue         , Xue         , Xue         , Xue         , Uh          , Uh          , Xue         , Xue         , Xue         , Xue         , Xue         , Xue         , Xue         , Xue         , Uue         , Xue         , Xue         , Xue         , Xue         , Xue         , Xue         , Xue         , Xue         
Xue         , Xue         , Xue         , Xue         , Xue         , Xue         , Xue         , Xue         , Xue         , Xue         , Uue         , Xue         , Uue         , Xue         , Xue         , Xue         , Xue         , Xue         , Xue         , Xue         , Xue         , Xue         , Uue         , Uue         , Uue         , Xue         , Uue         , Uh          , Uue^Vu      , Xue         , Co          , Xue         , Xue         , Xue         , Xue         , Xue         , Xue         , Xue         , Uue         , Xue         , Uue         , Xue         , Xue         , Xue         , Xue         , Xue         
Xue         , Xue         , Xue         , Xue         , Uue         , Xue         , Uue         , Uue^Vu      , Uue         , Uue         , Uue         , Uue         , Uue         , Uue         , Uue         , Uue^Vu      , Uue         , Xue         , Xue         , Xue         , Rb^Vu       , Uue         , Uue         , Uue         , Uue^Uf      , Uue         , Uue         , Uue         , Uue         , Uue         , Uue         , Co          , 2 Ko        , Xue         , Xue         , Xue         , Xue         , Uue         , Uue         , Uue         , Uue         , Uue         , Xue         , Xue         , Xue         , Xue         
Xue         , Xue         , Xue         , Uue         , Uue         , Uue         , Uue^Uf      , Uue         , Uue         , Uue         , Uue         , Uue         , Uue^Uf      , Uue^Uf      , Uue^Uf      , Uue^Uf      , Uue^Uf      , Uue         , Qxe         , Xue         , Rb          , Rb          , Uue         , Uue^Uf      , Uue^Uf      , Uue^Uf      , Uue^Uf      , Uue         , Uue         , Uue         , Uue         , Co          , Co          , Co          , Co          , Xue         , Xue         , Uue^Vud     , Ur          , Uue         , Uue         , Uue         , Uue^Uf      , Xue         , Xue         , Xue         
Xue         , Xue         , Uue^Vu      , Uue         , Uue^Uf      , Uue^Uf      , Uue^Uf      , Uue         , Uue         , Uue         , Co          , Uue         , Uue         , Uue^Uf      , Uue         , Uue^Uf      , Uue^Uf      , Uue         , Qxe         , Qxe         , Qxe         , Rb          , Ur          , Uue         , Ur          , Uue^Uf      , Uue^Uf      , Uue^Uf      , Ur          , Ur          , Ur          , Co          , Uue         , Uue         , Uue         , Uue         , Xue         , Xue         , Xue         , Ur          , Ur          , Uue         , Uue^Uf      , Uue         , Xue         , Xue         
Xue         , Xue         , Uue         , Uue         , Uue^Uf      , Uue^Uf      , Uue         , Uue         , Uue         , Co          , Xue         , Co          , Xue         , Uue         , Uue         , Uue         , Uue         , Uue         , Wwf         , Qxe         , Qxe         , Ur          , Qxe         , Ur          , Rb          , Ur          , Ur          , Ur          , Uue         , Uue         , Uue         , Uue         , Uue         , Uue         , Uue         , Uue         , Uue         , Xue         , Xue         , Xue         , Xue         , Ur          , Ur          , Uue         , Uue^Vud     , Xue         
Xue         , Xue         , Uue         , Uue         , Rb          , Rb^Uf       , Uue         , Uue         , 3 Ko        , Co          , Xue         , Xue         , Xue         , Xue         , Uue^Vu      , Uue         , Uue         , Uue         , Wwf         , Uue         , Uue         , Qxu^Bsz|    , Qxe         , Rb^Vu       , Rb          , Rb          , Ur          , Uue^Uf      , Uue^Uf      , Uue         , Uue^Uf      , Uue         , Uue         , Uue         , Uue         , Uue^Uf      , Uue         , Uue^Vu      , Xue         , Xue         , Xue         , Uue         , Uue         , Ur          , Ur          , Xue         
Xue         , Xue         , Uue         , Uue         , Rb          , Rb          , Uue         , Uue         , Co          , Xue         , Xue         , Xue         , Xue         , Xue         , Xue         , Uue         , Uue         , Uue         , Wwf         , Uue         , Ur          , Ur          , Uue         , Qxe         , Qxe         , Uue         , Ur          , Uue         , Uue         , Uue^Uf      , Uue^Uf      , Uue         , Uue         , Uue         , Uue         , Uue         , Uue         , Uue         , Xue         , Xue         , Uue         , Uue         , Uue         , Uue^Uf      , Ur          , Xue         
Xue         , Xue         , Xue         , Uue         , Uue^Uf      , Rb^Uf       , Uue         , Uue         , Co          , Xue         , Xue         , Xue         , Xue         , Xue         , Uue         , Uue         , Wwg         , Wwg         , Ur          , Ur          , Uue         , Uue         , Uue         , Qxe         , Qxe         , Uue         , Ur          , Uue         , Uue         , Uue^Uf      , Uue         , Uue         , Uue^Uf      , Uue^Uf      , Uue         , Uue         , Uue         , Xue         , Xue         , Xue         , Uue         , Uue^Uf      , Uue         , Uue         , Ur          , Xue         
Xue         , Xue         , Xue         , Uue         , Uue^Vu      , Uue^Uf      , Uue         , Uue         , Uue         , Co          , Uue         , Xue         , Xue         , Uue^Vu      , Wwg         , Wwg         , Ur          , Ur          , Uue         , Uue         , Uue         , Uue         , Uue         , Qxe         , Qxe         , Uue         , Ur          , Uue         , Uue         , Uue         , Uue         , Uue         , Uue^Uf      , Uue^Uf      , Uue         , Uue         , Uue         , Xue         , Xue         , Xue         , Uue         , Uue^Uf      , Uue^Uf      , Uue         , Ur          , Xue         
Xue         , Xue         , Uue         , Uue         , Uue^Uf      , Uue^Uf      , Uue         , Uue         , Uue         , Ur          , Uue         , Uue         , Wwg         , Wwg         , Ur          , Ur          , Uue         , Uue         , Uue^Uf      , Uue         , Uue         , Uue         , Uue         , Qxe         , Qxe         , Uue         , Ur          , Uue         , Uue         , Uue         , Uue         , Uue^Vu      , Uue^Uf      , Uue^Uf      , Uue         , Uue         , Uue         , Xue         , Xue         , Uue         , Uue         , Uue         , Uue         , Uue^Uf      , Ur          , Xue         
Xue         , Xue         , Uue         , Uue         , Uue^Uf      , Uue^Uf      , Uue^Uf      , Uue^Uf      , Uue         , Ur          , Ur          , Uue         , Wwg         , Ur          , Uue         , Uue         , Uue^Uf      , Uue^Uf      , Uue         , Uue^Uf      , Uue         , Uue         , Uue         , Qxe         , Qxe         , Ur          , Uue         , Uue         , Uue^Uf      , Uue^Uf      , Uue^Uf      , Uue^Uf      , Uue         , Uue         , Uue         , Uue         , Xue         , Xue         , Xue         , Xue         , Uue         , Uue^Uf      , Uue         , Uue^Uf      , Ur          , Xue         
Xue         , Xue         , Uue         , Uue         , Uue^Uf      , Uue^Vu      , Uue         , Uue^Uf      , Uue         , Uue         , Wwg         , Wwg^Bw\r    , Ur          , Ur          , Rb^Uf       , Uue^Uf      , Uue^Uf      , Uue^Uf      , Uue         , Uue         , Uue         , Uue         , Qxe         , Qxe         , Qxu^Bsz/    , Ur          , Uue         , Uue^Uf      , Uue         , Uue^Uf      , Uue         , Uue         , Uue         , Uue         , Uue         , Xue         , Xue         , Xue         , Xue         , Uue         , Uue         , Uue^Uf      , Uue         , Ur          , Uue         , Xue         
Xue         , Xue         , Xue         , Uue         , Uue         , Uue         , Uue         , Uue         , Wwg         , Wwg         , Uue         , Uue         , Uue         , Ur          , Rb^Uf       , Rb^Uf       , Ur          , Uue         , Uue         , Uue         , Qxe         , Qxe         , Qxu^Bsz/    , Uue         , Uue         , Qxe         , Qxe         , Uue         , Uue         , Uue         , Uue         , Uue         , Uue         , Uue         , Xue         , Xue         , Xue         , Xue         , Xue         , Xue         , Uue         , Uue         , Uue         , Ur          , Uue^Vud     , Xue         
Xue         , Xue         , Xue         , Uue         , Uue         , Uue         , Uue         , Uue         , Wwg         , Uue         , Uue         , Uue         , Uue         , Ur          , Ur          , Ur          , Uue         , Ur          , Qxu^Bsz\    , Qxe         , Ur          , Ur          , Uue         , Xue         , Xue         , Qxe         , Qxe         , Uue         , Uue^Vu      , Uue         , Xue         , Uue         , Xue         , Xue         , Xue         , Xue         , Xue         , Xue         , Ur          , Uue         , Ur          , Ur          , Ur          , Ur          , Xue         , Xue         
Xue         , Xue         , Xue         , Xue         , Uue         , Uue         , Uue^Uf      , Uue         , Wwg         , Rb          , Rb          , Uue         , Uue         , Uue         , Uue         , Uue         , Qxe         , Qxe         , Uue         , Ur          , Uue         , Ur          , Ur          , Uue^Vu      , Xue         , Xue         , Xue         , Qxe         , Xue         , Xue         , Xue         , Xue         , Xue         , Xue         , Xue         , Uue^Vud     , Ur          , Ur          , Uue         , Ur          , Xue         , Uue         , Xue         , Uue         , Xue         , Xue         
Xue         , Xue         , Xue         , Xue         , Uue         , Uue^Uf      , Uue         , Uue         , Wwg         , Rb          , Uue         , Uue         , Xue         , Xue         , Xue         , Uue         , Xue         , Qxe         , Xue         , Uue         , Uue         , Uue         , Uue^Uf      , Ur          , Ur          , Xue         , Xue         , Xue         , Xue         , Xue         , Xue         , Xue         , Uue         , Xue         , Ur          , Ur          , Uue         , Uue         , Xue         , Xue         , Xue         , Xue         , Xue         , Xue         , Xue         , Xue         
Xue         , Xue         , Wwg         , Xue         , Xue         , Uue         , Uue         , Uue         , Uue         , Wwg         , Wwg         , Uue         , Uue^Vu      , Xue         , Xue         , Xue         , Xue         , Xue         , Xue         , Xue         , Xue         , Uue         , Uue         , Uue^Uf      , Uue^Uf      , Ur          , Ur          , Xue         , Uue         , Xue         , Uue         , Uue         , Uue^Uf      , Ur          , Uue         , Uue         , Xue         , Xue         , Xue         , Xue         , Xue         , Xue         , Xue         , Xue         , Xue         , Xue         
Xue         , Xue         , Wwg         , Xue         , Xue         , Xue         , Xue         , Uue^Vu      , Xue         , Xue         , Xue         , Wwg         , Uue         , Xue         , Xue         , Xue         , Xue         , Xue         , Xue         , Xue         , Xue         , Xue         , Xue         , Uue         , Uue         , Uue^Uf      , Uue         , Ur          , Uue         , Uue         , Uue^Uf      , Uue^Uf      , Uue         , Ur          , Xue         , Xue         , Xue         , Xue         , Uue         , Uue         , Uue         , Uue         , Uue         , Xue         , Xue         , Xue         
Xue         , Xue         , Wwg         , Xue         , Xue         , Xue         , Xue         , Xue         , Xue         , Xue         , Xue         , Wwg         , Uue         , Uue         , Uue         , Uue         , Uue         , Xue         , Uue         , Xue         , Xue         , Xue         , Xue         , Xue         , Uue         , Uue         , Uue         , Ur          , Ur          , Uue         , Uue         , Uue^Uf      , Uue         , Ur          , Uue         , Uue         , Uue         , Uue         , Uue         , Uue         , Uue^Uf      , Uue         , Uue         , Uue         , Uue^Vud     , Xue         
Xue         , Xue         , Wwg         , Wwg         , Wwg         , Xue         , Wwg         , Xue         , Xue         , Xue         , Xue         , Wwg         , Wwg         , Wwg         , Wwg         , Wwg         , Wwg         , Uue         , Uue         , Uue^Vud     , Xue         , Xue         , Xue         , Xue         , Xue         , Uue         , Uue         , Uue         , Uue         , Ur          , Ur          , Uue         , Uue         , Ur          , Uue         , Uue         , Rb          , Rb          , Rb          , Uue         , Uue         , Uue^Uf      , Rb^Uf       , Rb          , Uue         , Xue         
Xue         , Xue         , Wwg         , Wwg         , Wwg         , Wwg         , Wwg         , Wog         , Wog         , Xue         , Xue         , Wog         , Wog         , Wwg         , Wog         , Wwg         , Wwg         , Uue         , Uue         , Uue         , Uue         , Xue         , Xue         , Xue         , Xue         , Xue         , Xue         , Uue         , Xue         , Uue         , Xue         , Ur          , Ur          , Ur          , Ur          , Uue         , Uue         , Rb          , Uue         , Uue         , Uue         , Uue^Uf      , Uue^Uf      , Rb          , Uue         , Xue         
Xue         , Xue         , Wog         , Wwg         , Wwg         , Wwg         , Wog         , Wog         , Xue         , Xue         , Xue         , Wog         , Wog         , Wog         , Wog         , Wwg         , Wwg         , Wwg         , Wwg         , Uue         , Uue         , Uue         , Xue         , Xue         , Xue         , Xue         , Xue         , Xue         , Xue         , Uue         , Xue         , Xue         , Xue         , Xue         , Ur          , Uue         , Uue^Uf      , Uue         , Xue         , Xue         , Uue         , Uue^Uf      , Uue         , Uue         , Uue         , Xue         
Xue         , Xue         , Xue         , Wog         , Wog         , Wog         , Wog         , Xue         , Xue         , Xue         , Wog         , Wog         , Wog         , Wog         , Wwg         , Wog         , Wog         , Wwg         , Wwg         , Wwg         , Xue         , Xue         , Xue         , Xue         , Uue^Vud     , Xue         , Uue         , Xue         , Uue^Uf      , Uue         , Xue         , Xue         , Xue         , Xue         , Ur          , Uue^Uf      , Uue^Uf      , Uue         , Xue         , Xue         , Uue^Vud     , Uue         , Uue         , Uue         , Xue         , Xue         
Xue         , Xue         , Xue         , Wog         , Xue         , Wog         , Xue         , Xue         , Xue         , Wog         , Wog         , Wog         , Wwg         , Wwg         , Wwg         , Wwg         , Wwg         , Wog         , Wog         , Wog         , Wog         , Wog         , Xue         , Xue         , Uue         , Uue         , Uue^Uf      , Uue^Uf      , Rb^Uf       , Uue         , Uue         , Xue         , Xue         , Xue         , Ur          , Uue^Uf      , Uue         , Uue         , Xue         , Xue         , Xue         , Uue         , Xue         , Xue         , Xue         , Xue         
Xue         , Xue         , Xue         , Xue         , Xue         , Xue         , Xue         , Xue         , Wog         , Wog         , Wwg         , Wwg         , Wwg         , Uue         , Uue         , Wwg         , Wwg         , Wwg         , Wog         , Wog         , Wog         , Wog         , Wog         , Xue         , Wwg         , Uue         , Rb          , Rb^Uf       , Rb          , Rb          , Xue         , Xue         , Xue         , Xue         , Uue^Vud     , Ur          , Ur          , Uue         , Xue         , Xue         , Xue         , Xue         , Xue         , Xue         , Xue         , Xue         
Xue         , Xue         , Xue         , Xue         , Wog         , Wog         , Wog         , Wog         , Wog         , Wog         , Wwg         , Wwg         , Uue         , Uue^Uf      , Uue^Uf      , Uue         , Wwg         , Wwg         , Wog         , Wog         , Wog         , Wog         , Wog         , Wog         , Wwg         , Wwg         , Wwg         , Uue         , Uue         , Uue         , Xue         , Xue         , Wwg         , Uue^Uf      , Uue         , Uue         , Ur          , Uue         , Xue         , Xue         , Xue         , Xue         , Xue         , Xue         , Xue         , Xue         
Xue         , Xue         , Xue         , Wog         , Wog         , Wog         , Wog         , Wog         , Wog         , Wog         , Wwg         , Wwg         , Wwg         , Uue^Uf      , Uue^Vud     , Wwg         , Wwg         , Wog         , Wog         , Wog         , Wog         , Wog         , Wog         , Wog         , Wwg         , Wwg         , Wwg         , Uue         , Wwf         , Uue         , Wwg         , Wwg         , Wwg         , Wwg         , Uue^Uf      , Uue         , Ur          , Uue         , Uue^Uf      , Xue         , Xue         , Xue         , Xue         , Xue         , Uue^Ii      , Uue         
Xue         , Xue         , Xue         , Xue         , Uue         , Wog         , Wog         , Wog         , Wog         , Wog         , Wwg         , Wwg         , Wwg         , Uue         , Uue         , Wwg         , Wwg         , Wog         , Wog         , Wog         , Wog         , Wog         , Wog         , Wog         , Wwg         , Wwg         , Wwg         , Wwf         , Uue         , Wwg         , Xue         , Xue         , Uue^Vud     , Wwg         , Uue         , Uue         , Uue^Uf      , Ur          , Ur          , Uue         , Uue         , Uue^Vud     , Uue^Uf      , Uue         , Uue^Ii      , Uue^Ii      
Xue         , Xue         , Xue         , Xue         , Uue         , Uue         , Wwg         , Wwg         , Wwg         , Wwg         , Wwg         , Wwg         , Wwg         , Wwg^Bw/r    , Wwg         , Wwg         , Wwg         , Wwg         , Wwg         , Wog         , Wog         , Wog         , Wog         , Wog         , Wwg         , Wwg         , Wwg         , Uue         , Rb^Vud      , Xue         , Xue         , Xue         , Uue^Uf      , Wwg^Bw\     , Uue         , Uue^Uf      , Uue^Uf      , Uue^Uf      , Uue         , Ur          , Ur          , Uue         , Uue         , Uue^Ii      , Wwg^Ii      , Wwg^Ii      
Xue         , Xue         , Xue         , Xue         , Uue^Vud     , Uue^Uf      , Rb          , Wwg         , Uue         , Wwg         , Wwg         , Wwg         , Wwg         , Wwg^Bw|r    , Wwg         , Wwg         , Wwg         , Wwg         , Wwg         , Wwg         , Wwg         , Wwg         , Wwg         , Wwg         , Wwg         , Wwg         , Rb^Uf       , Rb          , Uue         , Xue         , Xue         , Xue         , Xue         , Wwg         , Uue         , Uue         , Uue         , Uue^Fetd    , Uue         , Uue         , Ur          , Uue         , Ce          , Wwf^Ii      , Uue^Ii      , Uue^Ii      
Xue         , Xue         , Xue         , Xue         , Xue         , Uue^Uf      , Rb^Uf       , Rb          , Rb          , Uue         , Uue^Uf      , Wwg         , Uue         , Uue         , Uue         , Wwg         , Rb          , Uue^Vud     , Uue^Uf      , Uue^Uf      , Uue         , Uue         , Rb          , Wwg         , Uue         , Uue^Uf      , Uue^Uf      , Rb          , Xue         , Xue         , Xue         , Xue         , Xue         , Wwg         , Wwg         , Uue         , Uue         , Uue         , Uue         , Uue         , Wwf         , Ce          , 1 Ke^Ii     , Ce^Ii       , Uue^Ii      , Uue^Ii      
Xue         , Xue         , Xue         , Xue         , Xue         , Xue         , Xue         , Xue         , Xue         , Rb^Uf       , Uue^Uf      , Uue         , Xue         , Xue         , Xue         , Rb          , Rb          , Uue         , Uue^Uf      , Uue^Uf      , Rb          , Rb          , Rb          , Uue         , Uue         , Uue         , Xue         , Xue         , Xue         , Xue         , Xue         , Xue         , Xue         , Wwg         , Wwg         , Wwg         , Wwg         , Wwg         , Wwg         , Wwf         , Ur^Ii       , Ce^Ii       , Ce^Ii       , Ce^Ii       , Uue^Ii      , Uu^Ufi      
Xue         , Xue         , Xue         , Xue         , Xue         , Xue         , Xue         , Xue         , Xue         , Uue         , Xue         , Xue         , Xue         , Xue         , Xue         , Xue         , Xue         , Uue         , Xue         , Uue         , Xue         , Uue         , Xue         , Xue         , Xue         , Xue         , Xue         , Xue         , Xue         , Xue         , Xue         , Xue         , Xue         , Xue         , Xue         , Wwg         , Xue         , Wwg         , Uue^Ii      , Uue^Ii      , Uue^Ii      , Ur^Ii       , Uue^Ii      , Uue^Ii      , Uue^Ii      , Uu^Ufi      
Xue         , Xue         , Xue         , Xue         , Xue         , Xue         , Xue         , Xue         , Xue         , Xue         , Xue         , Xue         , Xue         , Xue         , Xue         , Xue         , Xue         , Xue         , Xue         , Xue         , Xue         , Xue         , Xue         , Xue         , Xue         , Xue         , Xue         , Xue         , Xue         , Xue         , Xue         , Xue         , Xue         , Xue         , Xue         , Xue         , Xue         , Uue^Ii      , Uue^Ii      , Uu^Ufi      , Uue^Ii      , Ur^Ii       , Ur^Ii       , Uue^Ii      , Uue^Ii      , Uue^Ii      
